ABATTOIRS|ABATTOIR
ABBREVIATIONS|ABBREVIATION
ABDOMENS|ABDOMEN
ABDOMINAL|ABDOMEN
ABERRATIONS|ABERRATION
ABETALIPOPROTEINEMIAS|ABETALIPOPROTEINEMIA
ABILITY|ABILITIES
ABNORMAL|ABN
ABNORMALITY|ABNORMALITIES
ABOMASUMS|ABOMASUM
ABORIGINES|ABORIGINE
ABORTIFACIENTS|ABORTIFACIENT
ABORTIONS|ABORTION
ABRASIONS|ABRASION
ABREACTIONS|ABREACTION
ABRIDGE|ABBREVIATION
ABSCESSES|ABSCESS
ABSENCES|ABSENCE
ABSENT|ABSENCE
ABSENTEEISMS|ABSENTEEISM
ABSORPTIOMETRY|ABSORPTIOMETRIES
ABSORPTIONS|ABSORPTION
ABSTINENCES|ABSTINENCE
ABSTRACTINGS|ABSTRACTING
ABSTRACTS|ABSTRACT
ABUSES|ABUSE
ABUTMENTS|ABUTMENT
ACADEMIC|UNIV
ACADEMIES|ACAD
ACADEMY|ACAD
ACANTHOCHEILONEMIASIS|ACANTHOCHEILONEMIASES
ACANTHOCYTES|ACANTHOCYTE
ACANTHOLYSIS|ACANTHOLYSES
ACARIASIS|ACARIASES
ACCELERATIONS|ACCELERATION
ACCELERATORS|ACCELERATOR
ACCELOGRAPHY|ACCELOGRAPHIES
ACCEPTABILITY|ACCEPTABILITIES
ACCEPTANCES|ACCEPTANCE
ACCEPTORS|ACCEPTOR
ACCESSES|ACCESS
ACCESSIBILITY|ACCESSIBILITIES
ACCIDENTS|ACCIDENT
ACCLIMATIZATIONS|ACCLIMATIZATION
ACCOMMODATIONS|ACCOMMODATION
ACCOUNTABILITY|ACCOUNTABILITIES
ACCOUNTINGS|ACCOUNTING
ACCREDITATIONS|ACCREDITATION
ACCRETAS|ACCRETA
ACCULTURATIONS|ACCULTURATION
ACCUMBENS|ACCUMBEN
ACENAPHTHENES|ACENAPHTHENE
ACETABULUMS|ACETABULUM
ACETALS|ACETAL
ACETAMIDES|ACETAMIDE
ACETANILIDE|ACETANILID
ACETANILIDES|ACETANILID
ACETATES|ACETATE
ACETO|ACETATE
ACETOACETATES|ACETOACETATE
ACETONITRILES|ACETONITRILE
ACETOPHENONES|ACETOPHENONE
ACETYLASES|ACETYLASE
ACETYLATIONS|ACETYLATION
ACETYLDIGITOXINS|ACETYLDIGITOXIN
ACETYLDIGOXINS|ACETYLDIGOXIN
ACETYLMURAMYLPEPTIDES|ACETYLMURAMYLPEPTIDE
ACETYLPHENYLALANYL|ACETYLPHENYLALANINE
ACETYLTHIAMINE|ACETYLTHIAMIN
ACETYLTRANSFERASES|ACETYLTRANSFERASE
ACETYLVALYL|ACETYLVALINE
ACHALASIAS|ACHALASIA
ACHIEVEMENTS|ACHIEVEMENT
ACHONDROPLASIAS|ACHONDROPLASIA
ACHROMIANS|ACHROMIAN
ACIDOSIS|ACIDOSES
ACIDS|ACID
ACLACINOMYCINS|ACLACINOMYCIN
ACLASIS|ACLASES
ACNES|ACNE
ACONITANS|ACONITAN
ACOUSTICS|ACOUSTIC
ACQUISITIONS|ACQUISITION
ACRIDINES|ACRIDINE
ACROCEPHALOSYNDACTYLIAS|ACROCEPHALOSYNDACTYLIA
ACROCEPHALY|ACROCEPHALIES
ACRODERMATITIS|ACRODERMATITIDES
ACRODYNIAS|ACRODYNIA
ACROMEGALY|ACROMEGALIES
ACROMIONS|ACROMION
ACROSOMES|ACROSOME
ACRYLAMIDES|ACRYLAMIDE
ACRYLATES|ACRYLATE
ACTINIDES|ACTINIDE
ACTINOBACILLOSIS|ACTINOBACILLOSES
ACTINOIDINS|ACTINOIDIN
ACTINOMYCETES|ACTINOMYCETE
ACTINOMYCOSIS|ACTINOMYCOSES
ACTINOTHERAPY|ACTINOTHERAPIES
ACTINS|ACTIN
ACTIONS|ACTION
ACTIVATIONS|ACTIVATION
ACTIVATOR|ACTIVATING
ACTIVATORS|ACTIVATING
ACTIVITY|ACTIVITIES
ACTS|ACT
ACUITY|ACUITIES
ACULEACINS|ACULEACIN
ACUMINATUM|ACUMINATA
ACUPOINTS|ACUPOINT
ACUPUNCTURES|ACUPUNCTURE
ACYLATIONS|ACYLATION
ACYLETHANOLAMINES|ACYLETHANOLAMINE
ACYLTRANSFERASES|ACYLTRANSFERASE
ADAMANTINOMAS|ADAMANTINOMA
ADAPTATION|ACCLIMATIZATION
ADAPTATIONS|ACCLIMATIZATION
ADAPTINS|ADAPTIN
ADDICTION|DEPEND
ADDICTIONS|DEPEND
ADDISONS|ADDISON
ADDITIVES|ADDITIVE
ADENITIS|ADENITIDES
ADENOCARCINOMAS|ADENOCARCINOMA
ADENOFIBROMAS|ADENOFIBROMA
ADENOHYPOPHYSIS|ADENOHYPOPHYSES
ADENOIDECTOMY|ADENOIDECTOMIES
ADENOIDS|ADENOID
ADENOLYMPHOMAS|ADENOLYMPHOMA
ADENOMAS|ADENOMA
ADENOMYOSIS|ADENOMYOSES
ADENOVIRUSES|ADENOVIRUS
ADHESINS|ADHESIN
ADHESIONS|ADHESION
ADHESIVENESSES|ADHESIVENESS
ADHESIVES|ADHESIVE
ADIES|
ADIE
ADIPOCERES|ADIPOCERE
ADIPOSE|OBESITIES
ADJUSTMENTS|ADJUSTMENT
ADJUVANTS|ADJUVANT
ADMINISTRATION|THER
ADMINISTRATIONS|ADMIN
ADMINISTRATIVE|ADMIN
ADMINISTRATORS|ADMINISTRATOR
ADMISSIONS|ADMISSION
ADMITTING|ADMIT
ADNEXITIS|ADNEXITIDES
ADOLESCENCES|ADOLESCENCE
ADOLESCENTS|ADOLESCENT
ADOPTIONS|ADOPTION
ADRENALECTOMY|ADRENALECTOMIES
ADRENOCEPTORS|ADRENOCEPTOR
ADRENOCORTICOTROPIC|ADRENOCORTICOTROPHIC
ADRENOLEUKODYSTROPHY|ADRENOLEUKODYSTROPHIES
ADRENORECEPTORS|ADRENORECEPTOR
ADSORPTIONS|ADSORPTION
ADULTERATIONS|ADULTERATION
ADULTORUMS|ADULTORUM
ADULTS|ADULT
ADVERTISEMENTS|ADVERTISEMENT
ADVERTISINGS|ADVERTISING
ADVOCACY|ADVOCACIES
AEDES|AEDE
AEROBIOSIS|AEROBIOSES
AEROPHAGY|AEROPHAGIES
AEROSOLS|AEROSOL
AERUGINOCINE|AERUGINOCIN
AETHIOPS|AETHIOP
AFFILIATION|RELAT
AFFILIATIONS|RELAT
AFFINITY|AFFINITIES
AFIBRINOGENEMIAS|AFIBRINOGENEMIA
AFLATOXINS|AFLATOXIN
AFTEREFFECTS|AFTEREFFECT
AFTERIMAGES|AFTERIMAGE
AGAMMAGLOBULINEMIAS|AGAMMAGLOBULINEMIA
AGENCY|AGENCIES
AGENTS|AGENT
AGES|AGE
AGEUSIAS|AGEUSIA
AGGLUTINATIONS|AGGLUTINATION
AGGLUTININS|AGGLUTININ
AGGREGATION|AGGREGATING
AGGREGATIONS|AGGREGATING
AGGRESSIONS|AGGRESSION
AGINGS|AGING
AGITATIONS|AGITATION
AGNOSIAS|AGNOSIA
AGORAPHOBIAS|AGORAPHOBIA
AGRAMMATISMS|AGRAMMATISM
AGRANULOCYTOSIS|AGRANULOCYTOSES
AGRAPHIAS|AGRAPHIA
AGREEMENTS|AGREEMENT
AGRICULTURES|AGRICULTURE
AIDES|AIDE
AIDS|AID
AIRCRAFTS|AIRCRAFT
AIRFLOWS|AIRFLOW
AIRPLANE|AIRCRAFT
AIRS|AIR
AIRSICKNESSES|AIRSICKNESS
ALANYL|ALANINE
ALASTRIMS|ALASTRIM
ALBAS|ALBA
ALBINISMS|ALBINISM
ALBINO|ALBINISM
ALBUMINS|ALBUMIN
ALBUMINURIAS|ALBUMINURIA
ALCHEMY|ALCHEMIES
ALCOHOLICS|ALCOHOLIC
ALCOHOLISMS|ALCOHOLISM
ALCOHOLS|ALCOHOL
ALDEHYDES|ALDEHYDE
ALDIMINES|ALDIMINE
ALEXIAS|ALEXIA
ALEXITHYMIAS|ALEXITHYMIA
ALFALFAS|ALFALFA
ALGINATES|ALGINATE
ALGORITHMS|ALGORITHM
ALIENATIONS|ALIENATION
ALIENS|ALIEN
ALIGNMENTS|ALIGNMENT
ALIZARINE|ALIZARIN
ALKALIES|ALKALI
ALKALIS|ALKALI
ALKALOIDS|ALKALOID
ALKALOSIS|ALKALOSES
ALKANES|ALKANE
ALKAPTONURIAS|ALKAPTONURIA
ALKYLATIONS|ALKYLATION
ALLANTOIS|ALLANTOI
ALLAPININE|ALLAPININ
ALLATAS|ALLATA
ALLELES|ALLELE
ALLERGENS|ALLERGEN
ALLERGIC|ALLERGIES
ALLERGY|ALLERGIES
ALLIGATORS|ALLIGATOR
ALLOANTIGENS|ALLOANTIGEN
ALLOCATIONS|ALLOCATION
ALLOGENIC|ALLOGENEIC
ALLOGRAFTS|ALLOGRAFT
ALLOPHYCOCYANINS|ALLOPHYCOCYANIN
ALLOTYPES|ALLOTYPE
ALLOWANCES|ALLOWANCE
ALLOWED|ALLOWABLE
ALLOYS|ALLOY
ALMANACS|ALMANAC
ALOPECIAS|ALOPECIA
ALOUATTAS|ALOUATTA
ALOXIPRINE|ALOXIPRIN
ALPACAS|ALPACA
ALPHA-METHYLDIGITOXIGENIN|ALPHA-METHYL-DIGITOXIGENIN
ALPHAVIRUSES|ALPHAVIRUS
ALPORTS|ALPORT
ALTERATION|ADJUSTMENT
ALTERATIONS|ADJUSTMENT
ALTERNATIVE|SUBSTITUTE
ALTERNATIVES|SUBSTITUTE
ALTITUDES|ALTITUDE
ALTRUISMS|ALTRUISM
ALVEOLALGIAS|ALVEOLALGIA
ALVEOLECTOMY|ALVEOLECTOMIES
ALVEOLOPLASTY|ALVEOLOPLASTIES
ALVEOLUS|ALVEOLI
ALZHEIMERS|ALZHEIMER
AMALGAMS|AMALGAM
AMANITINS|AMANITIN
AMAUROSIS|AMAUROSES
AMBAZONE|AMBAZON
AMBIDEXTERITY|AMBIDEXTERITIES
AMBLYOPIAS|AMBLYOPIA
AMBULANCES|AMBULANCE
AMBULATIONS|AMBULATION
AMBYSTOMAS|AMBYSTOMA
AMEBA|AMEBIASES
AMEBIASIS|AMEBIASES
AMEBOMAS|AMEBOMA
AMELIAS|AMELIA
AMELOBLASTOMAS|AMELOBLASTOMA
AMELOBLASTS|AMELOBLAST
AMELOGENESIS|AMELOGENESES
AMENDMENTS|AMENDMENT
AMENORRHEAS|AMENORRHEA
AMENORRHEIC|AMENORRHEA
AMERICANS|AMERICAN
AMERINDS|AMERIND
AMETROPIAS|AMETROPIA
AMIDASES|AMIDASE
AMIDE|AMID
AMIDES|AMID
AMIDINES|AMIDINE
AMIDINOTRANSFERASES|AMIDINOTRANSFERASE
AMIDOHYDROLASES|AMIDOHYDROLASE
AMIFLAMINE|AMIFLAMIN
AMINATIONS|AMINATION
AMINEPTINE|AMINEPTIN
AMINES|AMINE
AMINOACIDURIAS|AMINOACIDURIA
AMINOACRIDINES|AMINOACRIDINE
AMINOBUTYRIC|AMINOBUTYRATE
AMINOETHANOLS|AMINOETHANOL
AMINOGLUTARIC|AMINOGLUTARATE
AMINOGLYCOSIDES|AMINOGLYCOSIDE
AMINOHYDROLASES|AMINOHYDROLASE
AMINOMETHYLPHOSPHONIC|AMINOMETHYLPHOSPHONATE
AMINOPEPTIDASES|AMINOPEPTIDASE
AMINOPHENOLS|AMINOPHENOL
AMINOPROPANOLS|AMINOPROPANOL
AMINOPROPIONIC|AMINOPROPIONATE
AMINOPROPYLONE|AMINOPROPYLON
AMINOPYRIDINES|AMINOPYRIDINE
AMINOQUINOLINES|AMINOQUINOLINE
AMINOSALICYLIC|AMINOSALICYLATE
AMINOTRANSFERASES|AMINOTRANSFERASE
AMMOTHERAPY|AMMOTHERAPIES
AMNESIAS|AMNESIA
AMNESTIC|AMNESIC
AMNIOCENTESIS|AMNIOCENTESES
AMNIONITIS|AMNIONITIDES
AMNIONS|AMNION
AMNIOSCOPY|AMNIOSCOPIES
AMOPYROQUINE|AMOPYROQUIN
AMPHETAMINES|AMPHETAMINE
AMPHIBIAS|AMPHIBIA
AMPHIUMAS|AMPHIUMA
AMPHOLINES|AMPHOLINE
AMPHOLYTES|AMPHOLYTE
AMPLIFICATIONS|AMPLIFICATION
AMPLIFIERS|AMPLIFIER
AMPULLAS|AMPULLA
AMPUTATIONS|AMPUTATION
AMPUTEES|AMPUTEE
AMYGDALAS|AMYGDALA
AMYLASES|AMYLASE
AMYLODEXTRINS|AMYLODEXTRIN
AMYLOIDOSIS|AMYLOIDOSES
AMYLOPECTINOSIS|AMYLOPECTINOSES
ANAEROBIOSIS|ANAEROBIOSES
ANAL|ANI
ANALGESIAS|ANALGESIA
ANALGESICS|ANALGESIC
ANALOGS|ANALOG
ANALOGUE|ANALOG
ANALYSES|ANALYSE
ANALYSIS|ANALYSE
ANALYZERS|ANALYZER
ANAPHASES|ANAPHASE
ANAPHYLATOXINS|ANAPHYLATOXIN
ANAPHYLAXIS|ANAPHYLAXES
ANAPLASIAS|ANAPLASIA
ANAPLASMOSIS|ANAPLASMOSES
ANASTOMOSIS|ANASTOMOSES
ANCYLOSTOMIASIS|ANCYLOSTOMIASES
ANDERSENS|ANDERSEN
ANDROGENS|ANDROGEN
ANDROSTADIENE|ANDROSTADIEN
ANDROSTADIENES|ANDROSTADIEN
ANDROSTANE|ANDROSTAN
ANDROSTANES|ANDROSTAN
ANDROSTATRIENES|ANDROSTATRIENE
ANDROSTENE|ANDROSTEN
ANDROSTENEDIOLS|ANDROSTENEDIOL
ANDROSTENES|ANDROSTEN
ANECDOTES|ANECDOTE
ANEMIAS|ANEMIA
ANEMIC|ANEMIA
ANEMOMETERS|ANEMOMETER
ANEMONE|ANEMONA
ANEMONES|ANEMONA
ANENCEPHALY|ANENCEPHALIES
ANESTHESIAS|ANESTHESIA
ANESTHESIOLOGY|ANESTHESIOLOGIES
ANESTHETICS|ANESTHETIC
ANESTHETISTS|ANESTHETIST
ANESTHIA|ANESTHESIA
ANEUPLOIDY|ANEUPLOIDIES
ANEURYSMS|ANEURYSM
ANGELES|ANGEL
ANGER|HOSTILITIES
ANGERS|HOSTILITIES
ANGIITIS|ANGIITIDES
ANGINAS|ANGINA
ANGIOCARDIOGRAPHY|ANGIOCARDIOGRAPHIES
ANGIOEDEMAS|ANGIOEDEMA
ANGIOGENESIS|ANGIOGENESES
ANGIOGRAPHY|ANGIOGRAPHIES
ANGIOHEMOPHILIAS|ANGIOHEMOPHILIA
ANGIOKERATOMAS|ANGIOKERATOMA
ANGIOMAS|ANGIOMA
ANGIOMATOSIS|ANGIOMATOSES
ANGIOPATHY|ANGIOPATHIES
ANGIOPLASTY|ANGIOPLASTIES
ANGIOSARCOMAS|ANGIOSARCOMA
ANGIOTENSINS|ANGIOTENSIN
ANGLES|ANGLE
ANGUILLAS|ANGUILLA
ANGUILLULIASIS|ANGUILLULIASES
ANHIDROSIS|ANHIDROSES
ANHYDRIDES|ANHYDRIDE
ANILIDES|ANILIDE
ANIMALS|ANIMAL
ANIONS|ANION
ANIRIDIAS|ANIRIDIA
ANISEIKONIAS|ANISEIKONIA
ANISOCORIAS|ANISOCORIA
ANISOLES|ANISOLE
ANISOMETROPIAS|ANISOMETROPIA
ANKLES|ANKLE
ANKYLOSIS|ANKYLOSES
ANNELIDAS|ANNELIDA
ANNIVERSARY|ANNIVERSARIES
ANODES|ANODE
ANODONTIAS|ANODONTIA
ANOMALY|ANOMALIES
ANOMIAS|ANOMIA
ANOMIES|ANOMIE
ANONYMS|ANONYM
ANOPHELES|ANOPHELE
ANOPHTHALMIAS|ANOPHTHALMIA
ANOPLURAS|ANOPLURA
ANOREXIAS|ANOREXIA
ANOS|ANO
ANOSMIAS|ANOSMIA
ANOVAS|ANOVA
ANOVULATIONS|ANOVULATION
ANOXEMIAS|ANOXEMIA
ANOXIAS|ANOXIA
ANTACIDS|ANTACID
ANTAGONISM|BLOCK
ANTAGONISMS|BLOCK
ANTAGONIST|BLOCK
ANTAGONISTS|BLOCK
ANTELOPES|ANTELOPE
ANTELOPINES|ANTELOPINE
ANTHOCYANINS|ANTHOCYANIN
ANTHONYS|ANTHONY
ANTHRACENES|ANTHRACENE
ANTHRACOSILICOSIS|ANTHRACOSILICOSES
ANTHRAQUINONES|ANTHRAQUINONE
ANTHRAXS|ANTHRAX
ANTHROPOIDS|ANTHROPOID
ANTHROPOLOGY|ANTHROPOLOGIES
ANTHROPOSOPHY|ANTHROPOSOPHIES
ANTIBIOSIS|ANTIBIOSES
ANTIBIOTICS|ANTIBIOTIC
ANTIBODY|ANTIBODIES
ANTICHOLESTEROL|ANTICHOLESTEREMIC
ANTICOAGULANTS|ANTICOAGULANT
ANTICONVULSANTS|ANTICONVULSANT
ANTIDOTES|ANTIDOTE
ANTIEMETICS|ANTIEMETIC
ANTIFUNGUS|ANTIFUNGAL
ANTIGENS|ANTIGEN
ANTIGLOBULINS|ANTIGLOBULIN
ANTIHEMORRHAGICS|ANTIHEMORRHAGIC
ANTILIPEMIC|ANTICHOLESTEREMIC
ANTIMETABOLITES|ANTIMETABOLITE
ANTINEOPLASTICS|ANTINEOPLASTIC
ANTINEOPLASTONS|ANTINEOPLASTON
ANTIPLASMINS|ANTIPLASMIN
ANTIPORTERS|ANTIPORTER
ANTIPROTEASES|ANTIPROTEASE
ANTISEIZURE|ANTICONVULSANT
ANTISEPSIS|ANTISEPSES
ANTISEPTICS|ANTISEPTIC
ANTITHROMBINS|ANTITHROMBIN
ANTITOXINS|ANTITOXIN
ANTIVIRUS|ANTIVIRAL
ANTLERS|ANTLER
ANTRUMS|ANTRUM
ANTS|ANT
ANURIAS|ANURIA
ANUS|ANI
ANXIETIES|WORRIED
ANXIETY|WORRIED
ANXIOUS|WORRIED
AORTAS|AORTA
AORTIC|AORTA
AORTITIS|AORTITIDES
AORTOGRAPHY|AORTOGRAPHIES
APATITES|APATITE
APES|APE
APHAKIAS|APHAKIA
APHANIPTERAS|APHANIPTERA
APHASIAS|APHASIA
APHERESIS|APHERESES
APHIDS|APHID
APHONIAS|APHONIA
APHORISMS|APHORISM
APICES|APEX
APICOECTOMY|APICOECTOMIES
APLASIAS|APLASIA
APLYSIAS|APLYSIA
APNEAS|APNEA
APOLIPOPROTEINS|APOLIPOPROTEIN
APOPLEXY|APOPLEXIES
APOPROTEINS|APOPROTEIN
APPENDECTOMY|APPENDECTOMIES
APPENDICEAL|APPENDICES
APPENDICECTOMY|APPENDECTOMIES
APPENDICITIS|APPENDICITIDES
APPENDICULAR|APPENDICES
APPENDIX|APPENDICES
APPETITES|APPETITE
APPLES|APPLE
APPLIANCES|APPLIANCE
APPLICANTS|APPLICANT
APPLICATIONS|APPLICATION
APPOINTMENTS|APPOINTMENT
APPORTIONMENTS|APPORTIONMENT
APPRAISALS|APPRAISAL
APPROVAL|ACCEPTANCE
APRAXIAS|APRAXIA
APRICOTS|APRICOT
APTITUDE|ABILITIES
APTITUDES|ABILITIES
APUDOMAS|APUDOMA
AQUEDUCTS|AQUEDUCT
AQUOMETHEMOGLOBINS|AQUOMETHEMOGLOBIN
ARACHIS|ARACHI
ARACHNIDA|ARACHNID
ARACHNIDAS|ARACHNID
ARACHNODACTYLY|ARACHNODACTYLIES
ARACHNOIDITIS|ARACHNOIDITIDES
ARACHNOIDS|ARACHNOID
ARBOVIRUSES|ARBOVIRUS
ARC|AID
ARCHAEOLOGY|ARCHAEOLOGIES
ARCHENTERONS|ARCHENTERON
ARCHES|ARCH
ARCHITECTURES|ARCHITECTURE
ARCHIVES|ARCHIVE
ARCHS|ARCH
ARCUS|ARCU
AREAS|AREA
AREATAS|AREATA
ARENARUMS|ARENARUM
ARENAVIRUSES|ARENAVIRUS
ARGENTAFFINOMAS|ARGENTAFFINOMA
ARGINYL|ARGININE
ARGYRIAS|ARGYRIA
ARHINENCEPHALY|ARHINENCEPHALIES
ARMADILLOS|ARMADILLO
ARMS|ARM
AROCLORS|AROCLOR
AROUSALS|AROUSAL
ARRESTS|ARREST
ARRHENOBLASTOMAS|ARRHENOBLASTOMA
ARRHYTHMIAS|ARRHYTHMIA
ARRYTHMIA|ARRHYTHMIA
ARRYTHMIAS|ARRHYTHMIA
ARSENATES|ARSENATE
ARSENICALS|ARSENICAL
ARSONS|ARSON
ARTEMIAS|ARTEMIA
ARTEMISININE|ARTEMISININ
ARTERIOGRAPHY|ARTERIOGRAPHIES
ARTERIOLES|ARTERIOLE
ARTERIOSCLEROSIS|ARTERIOSCLEROSES
ARTERITIS|ARTERITIDES
ARTERY|ARTERIES
ARTHRALGIAS|ARTHRALGIA
ARTHRITIDES|ARTHRITI
ARTHRITIS|ARTHRITI
ARTHRODESIS|ARTHRODESES
ARTHROGRAPHY|ARTHROGRAPHIES
ARTHROGRYPOSIS|ARTHROGRYPOSES
ARTHROMYODYSPLASIAS|ARTHROMYODYSPLASIA
ARTHROPATHICAS|ARTHROPATHICA
ARTHROPLASTY|ARTHROPLASTIES
ARTHROPODS|ARTHROPOD
ARTHROSCOPY|ARTHROSCOPIES
ARTICAINE|ARTICAIN
ARTICLES|ARTICLE
ARTICULATORS|ARTICULATOR
ARTIODACTYLAS|ARTIODACTYLA
ARTS|ART
ARYLAMIDASES|ARYLAMIDASE
ARYLSULFATASES|ARYLSULFATASE
ASA|ASPIRIN
ASBESTOSIS|ASBESTOSES
ASCARIASIS|ASCARIASES
ASCARIDIASIS|ASCARIDIASES
ASCITES|ASCITE
ASCORBIC|ASCORBATE
ASEPSIS|ASEPSES
ASIALIAS|ASIALIA
ASIALOGLYCOPROTEINS|ASIALOGLYCOPROTEIN
ASIANS|ASIAN
ASPARAGINYL|ASPARAGINE
ASPARTIC|ASPARTATE
ASPARTYL|ASPARTATE
ASPARTYLAMINOMETHYLPHOSPHONIC|ASPARTYLAMINOMETHYLPHOSPHONATE
ASPARTYLHYDROXAMIC|ASPARTYLHYDROXAMATE
ASPECTS|ASPECT
ASPERGILLOSIS|ASPERGILLOSES
ASPHYXIAS|ASPHYXIA
ASPICULARIASIS|ASPICULARIASES
ASPIRATIONS|ASPIRATION
ASPIRATORS|ASPIRATOR
ASSAYS|ASSAY
ASSERTIVENESSES|ASSERTIVENESS
ASSESSMENT|APPRAISAL
ASSESSMENTS|APPRAISAL
ASSIGNMENTS|ASSIGNMENT
ASSIMILATIONS|ASSIMILATION
ASSISTANCE|AID
ASSISTANCES|AID
ASSISTANT|AIDE
ASSISTANTS|AIDE
ASSOCIATED|RELAT
ASSOCIATIONS|ASSOCIATION
ASTAXANTHINE|ASTAXANTHIN
ASTHENIAS|ASTHENIA
ASTHENOPIAS|ASTHENOPIA
ASTHMAS|ASTHMA
ASTHMATIC|ASTHMA
ASTIGMATISMS|ASTIGMATISM
ASTROCYTES|ASTROCYTE
ASTROCYTOMAS|ASTROCYTOMA
ASTROLOGY|ASTROLOGIES
ASTRONOMY|ASTRONOMIES
ASTROVIRUSES|ASTROVIRUS
ASYMMETRY|ASYMMETRIES
ASYNCHRONY|ASYNCHRONIES
ASYSTOLES|ASYSTOLE
ATAXIAS|ATAXIA
ATELECTASES|COLLAPS
ATELECTASIS|COLLAPS
ATELES|ATELE
ATHEROMAS|ATHEROMA
ATHEROSCLEROSIS|ATHEROSCLEROSES
ATHETOSIS|ATHETOSES
ATHLETES|ATHLETE
ATHLETICS|ATHLETIC
ATLAS|ATLA
ATLASES|ATLA
ATLVS|ATLV
ATMOSPHERES|ATMOSPHERE
ATOMIZERS|ATOMIZER
ATONIC|ATONIA
ATONY|ATONIA
ATRESIAS|ATRESIA
ATRIOPEPTINS|ATRIOPEPTIN
ATRIUM|ATRIAL
ATRIUMS|ATRIAL
ATROCITY|ATROCITIES
ATROPHY|ATROPHIES
ATTACHMENTS|ATTACHMENT
ATTACKS|ATTACK
ATTENDANTS|ATTENDANT
ATTENTIONS|ATTENTION
ATTENUATORS|ATTENUATOR
ATTITUDES|ATTITUDE
ATTRACTANTS|ATTRACTANT
ATTRITIONS|ATTRITION
AUDIOANALGESIAS|AUDIOANALGESIA
AUDIOLOGY|AUDIOLOGIES
AUDIOMETRY|AUDIOMETRIES
AUDIOTAPES|AUDIOTAPE
AUDITORY|ACOUSTIC
AUDITS|AUDIT
AUERBACHS|AUERBACH
AUGMENTATIONS|AUGMENTATION
AUJESZKYS|AUJESZKY
AURAL|ACOUSTIC
AURICLE|ATRIAL
AURICULAR|ATRIAL
AUROVERTINS|AUROVERTIN
AUSCULTATIONS|AUSCULTATION
AUSTRALORBIS|AUSTRALORBI
AUTHORITARIANISMS|AUTHORITARIANISM
AUTHORSHIPS|AUTHORSHIP
AUTISMS|AUTISM
AUTOANALYSIS|AUTOANALYSES
AUTOANTIBODY|AUTOANTIBODIES
AUTOANTIGENS|AUTOANTIGEN
AUTOBIOGRAPHY|AUTOBIOGRAPHIES
AUTOCRATIC|AUTHORITARIANISM
AUTOGRAFTS|AUTOGRAFT
AUTOIMMUNITY|AUTOIMMUNITIES
AUTOLYSIS|AUTOLYSES
AUTOMATIONS|AUTOMATION
AUTOMATISMS|AUTOMATISM
AUTOMOBILES|AUTOMOBILE
AUTOPHAGOCYTOSIS|AUTOPHAGOCYTOSES
AUTOPSY|AUTOPSIES
AUTORADIOGRAPHY|AUTORADIOGRAPHIES
AUTOREGULATIONS|AUTOREGULATION
AUTOSUGGESTIONS|AUTOSUGGESTION
AUTOTRANSFUSIONS|AUTOTRANSFUSION
AUTOTRANSPLANTS|AUTOTRANSPLANT
AUXILIARY|AUXILIARIES
AUXINS|AUXIN
AV|ATRIOVENTRICULAR
AVAILABILITY|AVAILABILITIES
AVERMECTINS|AVERMECTIN
AVIATION|AEROSPACE
AVIATIONS|AEROSPACE
AVIDITY|AVIDITIES
AVITAMINOSIS|AVITAMINOSES
AVIUMS|AVIUM
AVULSIONS|AVULSION
AWARDS|AWARD
AWARENESSES|AWARENESS
AXENOMYCINS|AXENOMYCIN
AXI|AXES
AXILLAS|AXILLA
AXIOM|APHORISM
AXIS|AXES
AXOLOTLS|AXOLOTL
AXONS|AXON
AYERZAS|AYERZA
AZEPINE|AZEPIN
AZEPINES|AZEPIN
AZETIDINES|AZETIDINE
AZIDES|AZIDE
AZIDOANILIDE|AZIDOANILIDATE
AZIDOBENZOYLLYSYL|AZIDOBENZOYLLYSINE
AZIDOPHENYLALANYL|AZIDOPHENYLALANINE
AZIRIDINES|AZIRIDINE
AZOCARMINE|AZOCARMIN
AZOCINES|AZOCINE
AZOOSPERMIAS|AZOOSPERMIA
AZOSEMIDE|AZOSEMID
AZOTEMIAS|AZOTEMIA
BABESIASIS|BABESIASES
BABESIOSIS|BABESIOSES
BABIES|BABY
BABOONS|BABOON
BACILLOMYCINE|BACILLOMYCIN
BACILLUS|BACILLI
BACKACHES|BACKACHE
BACKGROUNDS|BACKGROUND
BACKPAIN|BACKACHE
BACKS|BACK
BACTEREMIAS|BACTEREMIA
BACTERIA|BACILLI
BACTERIAL|BACILLARY
BACTERIOCHLOROPHYLLS|BACTERIOCHLOROPHYLL
BACTERIOCINS|BACTERIOCIN
BACTERIOLOGICAL|MICROBIOL
BACTERIOLOGIES|MICROBIOL
BACTERIOLOGY|MICROBIOL
BACTERIOLYSIS|BACTERIOLYSES
BACTERIOPHAGES|BACTERIOPHAGE
BACTERIUM|BACILLI
BACTERIURIAS|BACTERIURIA
BACULOVIRUSES|BACULOVIRUS
BADGES|BADGE
BADMINTONS|BADMINTON
BAGASSOSIS|BAGASSOSES
BAHAMAS|BAHAMA
BAKERS|BAKER
BALANCE|EQUILIBRIA
BALANCES|EQUILIBRIA
BALANITIS|BALANITIDES
BALANTIDIASIS|BALANTIDIASES
BALDING|ALOPECIA
BALDNESSES|BALDNESS
BALLISTICS|BALLISTIC
BALLISTOCARDIOGRAPHY|BALLISTOCARDIOGRAPHIES
BALLOONS|BALLOON
BALLS|BALL
BALNEOTHERAPY|BALNEOTHERAPIES
BALOS|BALO
BALSAMS|BALSAM
BANANAS|BANANA
BANDAGES|BANDAGE
BANDICOTAS|BANDICOTA
BANDINGS|BANDING
BANDS|BAND
BANGINGS|BANGING
BANGS|BANG
BANKRUPTCY|BANKRUPTCIES
BANKS|BANK
BARBERINGS|BARBERING
BARBITURATES|BARBITURATE
BARGAININGS|BARGAINING
BARLEYS|BARLEY
BARLOWS|BARLOW
BARNACLES|BARNACLE
BARORECEPTORS|BARORECEPTOR
BAROTRAUMAS|BAROTRAUMA
BARRETTS|BARRETT
BARRIERS|BARRIER
BARTS|BART
BARTTERS|BARTTER
BARUCAINIDE|BARUCAINID
BARYONS|BARYON
BASALIS|BASALI
BASEBALLS|BASEBALL
BASEDOWS|BASEDOW
BASES|BASE
BASKETBALLS|BASKETBALL
BASOPHILS|BASOPHIL
BASSES|BASS
BATHS|BATH
BATRACHOTOXINS|BATRACHOTOXIN
BATRIDENE|BATRIDEN
BATS|BAT
BATTERY|BATTERIES
BEACHE|BEACH
BEACHES|BEACH
BEAKS|BEAK
BEANS|BEAN
BEARS|BEAR
BEATS|BEAT
BEAUTY|BEAUTIES
BEAVERS|BEAVER
BECHTEREWS|BECHTEREW
BEDBUGS|BEDBUG
BEDDINGS|BEDDING
BEDS|BED
BEDSORES|BEDSORE
BEERS|BEER
BEES|BEE
BEETLES|BEETLE
BEHAVIORISMS|BEHAVIORISM
BEHAVIORS|BEHAVIOR
BEHCETS|BEHCET
BEJELS|BEJEL
BELCHINGS|BELCHING
BELIEFS|BELIEF
BELLS|BELL
BELLY|ABDOMEN
BELTS|BELT
BENEFICENCES|BENEFICENCE
BENEFITS|BENEFIT
BENORYLATE|BENORILATE
BENTAZONE|BENTAZON
BENZALDEHYDES|BENZALDEHYDE
BENZAMIDES|BENZAMIDE
BENZAMIDINES|BENZAMIDINE
BENZANTHRACENES|BENZANTHRACENE
BENZARONE|BENZARON
BENZAZEPINES|BENZAZEPINE
BENZBROMARONE|BENZBROMARON
BENZIDINES|BENZIDINE
BENZILATES|BENZILATE
BENZIMIDAZOLE|BENZIMIDAZOL
BENZIMIDAZOLES|BENZIMIDAZOL
BENZOATES|BENZOATE
BENZOCYCLOHEPTENES|BENZOCYCLOHEPTEN
BENZODIAZEPINE|BENZODIAZEPIN
BENZODIAZEPINES|BENZODIAZEPIN
BENZOFURANS|BENZOFURAN
BENZOMORPHANS|BENZOMORPHAN
BENZOPHENONES|BENZOPHENONE
BENZOPYRANS|BENZOPYRAN
BENZOPYRENES|BENZOPYRENE
BENZOTHIADIAZINES|BENZOTHIADIAZINE
BENZOTRIPTE|BENZOTRIPT
BENZPYRENE|BENZOPYRENE
BENZYDAMINE|BENZIDAMINE
BENZYLAMINES|BENZYLAMINE
BEOSPIRS|BEOSPIR
BERBINES|BERBINE
BERGERS|BERGER
BERIBERUS|BERIBERI
BERNARDS|BERNARD
BEROTEK|BEROTEC
BERRY|BERRIES
BERTIELLIASIS|BERTIELLIASES
BERYLLIOSIS|BERYLLIOSES
BESNOITIASIS|BESNOITIASES
BETAS|BETA
BETATRONS|BETATRON
BEVERAGES|BEVERAGE
BEZOARS|BEZOAR
BIASES|BIAS
BIBENZYLS|BIBENZYL
BIBLES|BIBLE
BIBLIOGRAPHY|BIBLIOGRAPHIES
BIBLIOMETRICS|BIBLIOMETRIC
BIBLIOTHERAPIES|BIBLIOTHER
BIBLIOTHERAPY|BIBLIOTHER
BICARBONATES|BICARBONATE
BICARPHENE|BICARPHEN
BICUSPIDS|BICUSPID
BICYCLE|CYCL
BICYCLINGS|BICYCLING
BIDDINGS|BIDDING
BIFIDAS|BIFIDA
BIGEMINAS|BIGEMINA
BIGUANIDES|BIGUANIDE
BIKES|BIKE
BILAYERS|BILAYER
BILES|BILE
BILHARZIASIS|BILHARZIASES
BILIARY|BILE
BILIRUBINEMIAS|BILIRUBINEMIA
BILIVERDINE|BILIVERDIN
BILL|ACT
BINAZINE|BINAZIN
BINDING|BINDER
BINDINGS|BINDER
BIOASSAYS|BIOASSAY
BIOAVAILABILITY|BIOAVAILABILITIES
BIOBIBLIOGRAPHY|BIOBIBLIOGRAPHIES
BIOCHEMICAL|BIOCHEM
BIOCHEMISTRY|BIOCHEM
BIODEGRADATIONS|BIODEGRADATION
BIOENERGETICS|BIOENERGETIC
BIOEQUIVALENCES|BIOEQUIVALENCE
BIOETHIC|ETHIC
BIOETHICS|ETHIC
BIOGENESIS|BIOGENESES
BIOGRAPHY|BIOGRAPHIES
BIOINORGANIC|BIOINORG
BIOLOGIC|BIOL
BIOLOGICAL|BIOL
BIOLOGICS|BIOL
BIOMASSES|BIOMASS
BIOMECHANICS|BIOMECHANIC
BIOMED|MED
BIOMEDICAL|MED
BIOMPHALARIAS|BIOMPHALARIA
BIONATORS|BIONATOR
BIOPERIODICITY|BIOPERIODICITIES
BIOPHARMACEUTICS|BIOPHARMACEUTIC
BIOPHYSIC|PHYSIC
BIOPHYSICS|PHYSIC
BIOPROBES|BIOPROBE
BIOPROSTHESES|PROSTHESE
BIOPROSTHESIS|PROSTHESE
BIOPSY|BIOPSIES
BIORHYTHMS|BIORHYTHM
BIOSENSORS|BIOSENSOR
BIOSTATIST|STATIST
BIOSTATISTICS|STATIST
BIOSYNTHETIC|BIOSYN
BIOTECHNOLOGIES|TECHNOLOGIES
BIOTECHNOLOGY|TECHNOLOGIES
BIOTINYLATED|BIOTINYL
BIOTRANSFORMATIONS|BIOTRANSFORMATION
BIPERIDENE|BIPERIDEN
BIPHENYLAMINES|BIPHENYLAMINE
BIPOLAR|BIPOL
BIRD|AVIAN
BIRDS|AVIAN
BIREFRACTIONS|BIREFRACTION
BIREFRINGENCES|BIREFRINGENCE
BIRTH|CONGEN
BIRTHS|CONGEN
BISONS|BISON
BISPHOSPHATAS|BISPHOSPHATA
BISPHOSPHATASE|BISPHOSPHATA
BISPHOSPHOGLYCERATES|BISPHOSPHOGLYCERATE
BISPHOSPHONATES|BISPHOSPHONATE
BISULFITES|BISULFITE
BITES|BITE
BLACKFLY|BLACKFLIES
BLACKNESS|BLACK
BLACKS|BLACK
BLADDERS|BLADDER
BLASTOCYSTS|BLASTOCYST
BLASTOCYTES|BLASTOCYTE
BLASTODERMS|BLASTODERM
BLASTOGENESIS|BLASTOGENESES
BLASTOMERES|BLASTOMERE
BLASTOMYCOSIS|BLASTOMYCOSES
BLASTOPORES|BLASTOPORE
BLASTS|BLAST
BLASTULAS|BLASTULA
BLEACHINGS|BLEACHING
BLEBS|BLEB
BLEEDINGS|BLEEDING
BLEEDS|BLEED
BLENNORRHAGICAS|BLENNORRHAGICA
BLENNORRHEAS|BLENNORRHEA
BLEOMYCINS|BLEOMYCIN
BLEPHARITIS|BLEPHARITIDES
BLEPHAROPTOSIS|BLEPHAROPTOSES
BLEPHAROSPASMS|BLEPHAROSPASM
BLINDNESS|AMAUROSES
BLINKINGS|BLINKING
BLISTERS|BLISTER
BLOCKADERS|BLOCK
BLOCKER|BLOCK
BLOCKERS|BLOCK
BLOCKING|BLOCK
BLOCKS|BLOCK
BLOODLETTINGS|BLOODLETTING
BLOODS|BLOOD
BLOOMS|BLOOM
BLOTTING|BLOT
BLOTTINGS|BLOT
BLUECOMBS|BLUECOMB
BLUEGILLS|BLUEGILL
BLURRING|BLURRED
BLUSHINGS|BLUSHING
BOARDS|BOARD
BODY|BODIES
BOECKS|BOECK
BOGAERTS|BOGAERT
BOIL|FURUNCULOSES
BOILS|FURUNCULOSES
BONDINGS|BONDING
BONDS|BOND
BONES|BONE
BOOKBINDINGS|BOOKBINDING
BOOKPLATES|BOOKPLATE
BOOKS|BOOK
BOOKSELLERS|BOOKSELLER
BOOKSELLINGS|BOOKSELLING
BOOMS|BOOM
BORANES|BORANE
BORATES|BORATE
BORDERS|BORDER
BOREDOMS|BOREDOM
BORNE|TRANSM
BOROHYDRIDES|BOROHYDRIDE
BOTANICAL|BOTANIC
BOUILLAUDS|BOUILLAUD
BOURNEVILLES|BOURNEVILLE
BOWENS|BOWEN
BOWS|BOW
BOXES|BOX
BOXINGS|BOXING
BOXS|BOX
BRACES|BRACE
BRACHIOPODAS|BRACHIOPODA
BRACHYDANIOS|BRACHYDANIO
BRACHYTHERAPIES|BRACHYTHER
BRACHYTHERAPY|BRACHYTHER
BRADYARRHYTHMIAS|BRADYARRHYTHMIA
BRADYCARDIAS|BRADYCARDIA
BRAIN|CEREB
BRAINS|CEREB
BRAINWASHINGS|BRAINWASHING
BRANCHIOMAS|BRANCHIOMA
BRANS|BRAN
BRAZILIENSIS|BRASILIENSIS
BREADS|BREAD
BREAKS|BREAK
BREASTS|BREAST
BREATHING|RESP
BREATHINGS|RESP
BREEDERS|BREEDER
BREEDINGS|BREEDING
BRIDGEWORKS|BRIDGEWORK
BRILLS|BRILL
BRITISH|BRITAIN
BROADSIDES|BROADSIDE
BROFAROMINE|BROFAROMIN
BROMATE|BROMAT
BROMATES|BROMAT
BROMELAINS|BROMELAIN
BROMELINS|BROMELIN
BROMIDES|BROMIDE
BROMOACETIC|BROMOACETATE
BROMOACETYLLYSYL|BROMOACETYLLYSINE
BROMOACETYLPHENYLALANYL|BROMOACETYLPHENYLALANINE
BROMOBENZENES|BROMOBENZENE
BROMOBENZOATES|BROMOBENZOATE
BROMOCRESOL|BROMCRESOL
BROMOCRIPTINE|BROMOCRIPTIN
BROMOCRYPTIN|BROMOCRIPTIN
BROMODEOXYURIDINE|BROMDEOXYURIDIN
BROMODODECANOIC|BROMODODECANOATE
BROMOERGOKRYPTINE|BROMOERGOCRYPTINE
BROMOHYDRINS|
BROMOHYDRIN
BROMOPRIDE|BROMOPRID
BROMOSTEARIC|BROMOSTEARATE
BROMPHENOL|BROMOPHENOL
BROMURACIL|BROMOURACIL
BRONCHIAL|PULM
BRONCHIECTASIS|BRONCHIECTASES
BRONCHIOLES|BRONCHIOLE
BRONCHIOLITIS|BRONCHIOLITIDES
BRONCHITIS|BRONCHITIDES
BRONCHOCONSTRICTIONS|BRONCHOCONSTRICTION
BRONCHOGRAPHY|BRONCHOGRAPHIES
BRONCHOPNEUMONIAS|BRONCHOPNEUMONIA
BRONCHOPULMONARY|BRONCHOPULM
BRONCHOSCOPY|BRONCHOSCOPIES
BRONCHOSPASMS|BRONCHOSPASM
BRONCHOSPIROMETRY|BRONCHOSPIROMETRIES
BRONCHUS|BRONCHI
BROWNINGS|BROWNING
BRUCELLOSIS|BRUCELLOSES
BRUISE|BRUISABILITY
BRUISING|BRUISABILITY
BRUITS|BRUIT
BRUNEOMYCIN|BRUNEMYCIN
BRUNNERS|BRUNNER
BRUXISMS|BRUXISM
BRYOZOAS|BRYOZOA
BUBBLES|BUBBLE
BUCKLINGS|BUCKLING
BUDDHISMS|BUDDHISM
BUDGERIGARS|BUDGERIGAR
BUDGETS|BUDGET
BUDS|BUD
BUERGERS|BUERGER
BUFADIENOLIDES|BUFADIENOLIDE
BUFFALOE|BUFFALO
BUFFALOES|BUFFALO
BUFFERS|BUFFER
BUFOS|BUFO
BUFOTENINE|BUFOTENIN
BUGS|BUG
BUILDINGS|BUILDING
BUILDS|BUILD
BULBOKAPNIN|BULBOCAPNINE
BULBS|BULB
BULIMIAS|BULIMIA
BULLA|BLISTER
BULLAE|BLISTER
BULLAS|BLISTER
BULLFROGS|BULLFROG
BULLOSAS|BULLOSA
BUMETHANIDE|BUMETANIDE
BUNDLES|BUNDLE
BUNGAROTOXINS|BUNGAROTOXIN
BUNIONS|BUNION
BUNOSTOMIASIS|BUNOSTOMIASES
BUPHENIN|BUFENINE
BUPHENINE|BUFENINE
BUPHTHALMOS|BUPHTHALMIA
BURDENS|BURDEN
BURIALS|BURIAL
BURKITTS|BURKITT
BURNING|BURN
BURNISHINGS|BURNISHING
BURNOUTS|BURNOUT
BURNS|BURN
BURPING|BELCHING
BURSAS|BURSA
BURSITIS|BURSITIDES
BUSINESSES|BUSINESS
BUSTS|BUST
BUSULPHAN|BUSULFAN
BUTADIENES|BUTADIENE
BUTADIONE|BUTADION
BUTANE|BUTAN
BUTANEDIOLS|BUTANEDIOL
BUTANES|BUTAN
BUTANOLS|BUTANOL
BUTANONES|BUTANONE
BUTAPYRAZOLE|BUTAPIRAZOL
BUTIROSINS|BUTIROSIN
BUTOCINE|BUTOCIN
BUTTERFLY|BUTTERFLIES
BUTTERS|BUTTER
BUTTOCKS|BUTTOCK
BUTYLAMINES|BUTYLAMINE
BUTYLBORONIC|BUTYLBORONATE
BUTYLCYCLOHEXYLCARBOXYLIC|BUTYLCYCLOHEXYLCARBOXYLATE
BUTYRATES|BUTYRATE
BUTYROPHENONES|BUTYROPHENONE
BYLAWS|BYLAW
BYPASSE|BYPASS
BYPASSES|BYPASS
BYSSINOSIS|BYSSINOSES
CACAOS|CACAO
CACHEXIAS|CACHEXIA
CADAVERS|CADAVER
CAFFEAS|CAFFEA
CAGES|CAGE
CAIMANS|CAIMAN
CALCIFEROLS|CALCIFEROL
CALCIFICATIONS|CALCIFICATION
CALCINOSIS|CALCINOSES
CALCIPARINE|CALCIPARIN
CALCIPHYLAXI|CALCIPHYLAXES
CALCIPHYLAXIS|CALCIPHYLAXES
CALCULATIONS|CALCULATION
CALCULATORS|CALCULATOR
CALCULI|STONE
CALCULUS|STONE
CALIBRATIONS|CALIBRATION
CALICES|CALICE
CALICIVIRUSES|CALICIVIRUS
CALISTHENICS|CALISTHENIC
CALLIMICOS|CALLIMICO
CALLITHRIX|CALLITHRICES
CALLITRICHIDAE|CALLITHRICIDAE
CALLOSITY|CALLOSITIES
CALLOSUMS|CALLOSUM
CALLS|CALL
CALMECINE|CALMECIN
CALMETTES|
CALMETTE
CALOPHYLLOLIDE|CALOPHYLLOLID
CALORIE|CAL
CALORIMETRY|CALORIMETRIES
CALORY|CAL
CAMELIDS|CAMELID
CAMELLIAS|CAMELLIA
CAMELS|CAMEL
CAMERAS|CAMERA
CAMOQUINE|CAMOQUIN
CAMPIMETRY|CAMPIMETRIES
CAMPINGS|CAMPING
CAMPS|CAMP
CAMPTOTHECINE|CAMPTOTHECIN
CAMS|CAM
CAMYLOFINE|CAMYLOFIN
CANALICULUS|CANALICULI
CANALS|CANAL
CANARY|CANARIES
CANCER|NEOPL
CANCERS|NEOPL
CANDIDIASIS|CANDIDIASES
CANDY|CANDIES
CANES|CANE
CANNABINOIDS|CANNABINOID
CANNABIS|MARIHUANA
CANNIBALISMS|CANNIBALISM
CANNULAS|CANNULA
CANNULATIONS|CANNULATION
CANTHARIDINE|CANTHARIDIN
CANTHAXANTHINE|CANTHAXANTHIN
CAOUTCHOUCS|CAOUTCHOUC
CAPABILITY|ABILITIES
CAPACITATIONS|CAPACITATION
CAPACITIES|CAPAC
CAPACITY|CAPAC
CAPILLARITY|CAPILLARITIES
CAPILLARY|CAPILLARIES
CAPITIS|CAPITIDES
CAPLANS|CAPLAN
CAPNOMETRY|CAPNOMETRIES
CAPPINGS|CAPPING
CAPRINES|CAPRINE
CAPROATES|CAPROATE
CAPRYLATES|CAPRYLATE
CAPS|CAP
CAPSAICINE|CAPSAICIN
CAPSICUMS|CAPSICUM
CAPSIDS|CAPSID
CAPSULES|CAPSULE
CAR|AUTOMOBILE
CARBAMATES|CARBAMATE
CARBAMYL|CARBAMOYL
CARBAPENEMS|CARBAPENEM
CARBAZOLES|CARBAZOLE
CARBENOXALONE|CARBENEOXOLONE
CARBENOXOLONE|CARBENEOXOLONE
CARBOCHROMENE|CARBOCHROMEN
CARBOCROMENE|CARBOCROMEN
CARBODIIMIDES|CARBODIIMIDE
CARBOFOS|CARBAFOS
CARBOHYDRATES|CARBOHYDRATE
CARBOLINES|CARBOLINE
CARBONATES|CARBONATE
CARBOPHOS|CARBAFOS
CARBOS|CARBO
CARBOXAMIDEMETHYLATED|CARBOXAMIDEMETHYL
CARBOXYKINASES|CARBOXYKINASE
CARBOXYLASES|CARBOXYLASE
CARBOXYLATES|CARBOXYLATE
CARBOXYLESTERASES|CARBOXYLESTERASE
CARBOXYLIC|CARBOXYLATE
CARBOXYLINE|CARBOXYLIN
CARBOXYMUCINS|CARBOXYMUCIN
CARBOXYPEPTIDASES|CARBOXYPEPTIDASE
CARBUNCLES|CARBUNCLE
CARCINOGENS|CARCINOGEN
CARCINOID|ARGENTAFFINOMA
CARCINOMA|NEOPL
CARCINOMAS|NEOPL
CARCINOSARCOMAS|CARCINOSARCOMA
CARDIAS|CARDIA
CARDIOGRAPHY|CARDIOGRAPHIES
CARDIOLIPINS|CARDIOLIPIN
CARDIOMEGALY|CARDIOMEGALIES
CARDIOMYOPATHIES|CARDIOMYOP
CARDIOMYOPATHY|CARDIOMYOP
CARDIOPLEGIAS|CARDIOPLEGIA
CARDIOPULMONARY|CARDIOPULM
CARDIOSPASMS|CARDIOSPASM
CARDIOTOCOGRAPHY|CARDIOTOCOGRAPHIES
CARDIOTONICS|CARDIOTONIC
CARDIOTOXINS|CARDIOTOXIN
CARDIOVASCULAR|CARDIOVASC
CARDIOVERSIONS|CARDIOVERSION
CARDS|CARD
CARES|CARE
CARIBOUS|CARIBOU
CARICATURES|CARICATURE
CARINII|CARINI
CAROTENES|CAROTENE
CAROTENOIDS|CAROTENOID
CAROTENOPROTEINS|CAROTENOPROTEIN
CARPETS|CARPET
CARPHECILLIN|CARFECILLIN
CARPROFILINE|CARPROFILIN
CARPS|CARP
CARRIED|TRANSM
CARRIERS|CARRIER
CARRIONS|CARRION
CARSICKNESSES|CARSICKNESS
CARTICAINE|CARTICAIN
CARTILAGES|CARTILAGE
CARTOONS|CARTOON
CASEINS|CASEIN
CASEOSAS|CASEOSA
CASES|CASE
CASOMORPHINS|CASOMORPHIN
CASTES|CASTE
CASTINGS|CASTING
CASTLEMANS|CASTLEMAN
CASTORS|CASTOR
CASTRATIONS|CASTRATION
CASTS|CAST
CATALEPSY|CATALEPSIES
CATALOGINGS|CATALOGING
CATALOGS|CATALOG
CATALYSIS|CATALYSES
CATAMINE|CATAMIN
CATAPLEXY|CATAPLEXIES
CATAPRESSAN|CATAPRESAN
CATARACTS|CATARACT
CATARRHINAS|CATARRHINA
CATARRHS|CATARRH
CATATONIAS|CATATONIA
CATATONIC|CATATONIA
CATATOXIC|CATATOX
CATECHOLAMINES|CATECHOLAMINE
CATECHOLS|CATECHOL
CATESBEIANAS|CATESBEIANA
CATFISHES|CATFISH
CATFISHS|CATFISH
CATGUTS|CATGUT
CATHARSIS|CATHARSES
CATHARTICS|CATHARTIC
CATHEPSINS|CATHEPSIN
CATHETER|CATH
CATHETERIZATIONS|CATHETERIZATION
CATHETERS|CATH
CATHEXIS|CATHEXI
CATHODES|CATHODE
CATHOLICISMS|CATHOLICISM
CATIONS|CATION
CATS|CAT
CATTLE|BOVINE
CATTLES|BOVINE
CAUCASIAN|ALBA
CAUCASOID|ALBA
CAUDATAS|CAUDATA
CAUSALGIAS|CAUSALGIA
CAUSALITY|CAUSALITIES
CAUSATIONS|CAUSATION
CAUSES|CAUSE
CAUSTICS|CAUSTIC
CAUTERY|CAUTERIES
CAVAS|CAVA
CAVERNITIS|CAVERNITIDES
CAVHS|CAVH
CAVIAS|CAVIA
CAVITY|CAVITIES
CAYMAN|CAIMAN
CAYMANS|CAIMAN
CEBUELLAS|CEBUELLA
CEBUS|CEBU
CECOSTOMY|CECOSTOMIES
CECUMS|CECUM
CEFOPERAZONE|CEFOPERAZON
CEFOTAXIME|CEFOTAXIM
CEFTEZOLE|CEFTEZOL
CEFTOTAN|CEFOTAN
CEFTRIAXONE|CEFTRIAXON
CEFUZONAME|CEFUZONAM
CELLOPHANES|CELLOPHANE
CELLS|CELL
CELLULAR|CELL
CELLULITIS|CELLULITIDES
CEMENTATIONS|CEMENTATION
CEMENTOBLASTS|CEMENTOBLAST
CEMENTOMAS|CEMENTOMA
CEMENTS|CEMENT
CEMENTUMS|CEMENTUM
CEMETERY|CEMETERIES
CENSUSES|CENSUS
CENTENARIANS|CENTENARIAN
CENTERS|CENTER
CENTRAL|CENT
CENTRALIS|CENTRALI
CENTRIFUGATIONS|CENTRIFUGATION
CENTRIFUGE|CENTRIFUGATION
CENTRIOLES|CENTRIOLE
CENTROMERES|CENTROMERE
CENURIASIS|CENURIASES
CEPHACETRILE|CEFACETRILE
CEPHADROXYL|CEFADROXIL
CEPHALEXIN|CEFALEXIN
CEPHALIC|CEREB
CEPHALINS|CEPHALIN
CEPHALOGLYCINE|CEPHALOGLYCIN
CEPHALOMETRY|CEPHALOMETRICS
CEPHALORIDINE|CEPHALORIDIN
CEPHALOSPORINS|CEPHALOSPORIN
CEPHALOTAXUS|CEPHALOTAXINE
CEPHAMANDOLE|CEFAMANDOLE
CEPHAMEZINE|CEFAMEZINE
CEPHAMYCINS|CEPHAMYCIN
CEPHAPIRIN|CEFAPIRIN
CEPHARANTHINE|CEPHARANTHIN
CEPHAZOLIN|CEFAZOLIN
CEPHOTAXIM|CEFOTAXIM
CEPHRADINE|CEFRADINE
CEPHUROXIME|CEFUROXIME
CERAMICS|CERAMIC
CERAMIDES|CERAMIDE
CEREALS|CEREAL
CEREBELLOPONTINE|CEREBELLOPONTILE
CEREBELLUMS|CEREBELLUM
CEREBRAL|CEREB
CEREBROSIDES|CEREBROSIDE
CEREBROSPINAL|CEREBROSP
CEREBROVASCULAR|CEREBROVASC
CEREBRUM|CEREB
CEREMONIALS|CEREMONIAL
CEREVISAE|CEREV
CEREVISIAE|CEREV
CEREXINS|CEREXIN
CERTIFICATES|CERTIFICATE
CERTIFICATIONS|CERTIFICATION
CERULEIN|CAERULEIN
CERULETIDE|CERULETID
CERULEUS|CAERULEUS
CERULOPLASMIN|CAERULOPLASMIN
CERUMENS|CERUMEN
CERVICES|CERVICAL
CERVICITIS|CERVICITIDES
CERVICOFACIAL|CERVICOFAC
CERVIX|CERVICAL
CESAREANS|CESAREAN
CESTODE|CESTODA
CESTODES|CESTODA
CETACEAS|CETACEA
CETAMIUM|CATAMIUM
CHAINS|CHAIN
CHAIRS|CHAIR
CHALAZODERMIA|CHALAZODERMA
CHALKONE|CHALCONE
CHALONES|CHALONE
CHAMBERS|CHAMBER
CHAMPUS|CHAMPU
CHANCRES|CHANCRE
CHANCROIDS|CHANCROID
CHANGES|CHANGE
CHANNELS|CHANNEL
CHAPTERS|CHAPTER
CHARACTERISTICS|CHARACTERISTIC
CHARACTERS|CHARACTER
CHARCOALS|CHARCOAL
CHARCOTS|CHARCOT
CHARGES|CHARGE
CHARITY|CHARITIES
CHARTS|CHART
CHEEK|BUCCA
CHEEKS|BUCCA
CHEESES|CHEESE
CHEETAHS|CHEETAH
CHEILITIS|CHEILITIDES
CHELATES|CHELATE
CHEMEXFOLIATIONS|CHEMEXFOLIATION
CHEMICAL|CHEM
CHEMICALS|CHEM
CHEMISTRY|CHEMISTRIES
CHEMOATTRACTANTS|CHEMOATTRACTANT
CHEMODECTOMAS|CHEMODECTOMA
CHEMOLYSIS|CHEMOLYSES
CHEMONUCLEOLYSIS|CHEMONUCLEOLYSES
CHEMORECEPTORS|CHEMORECEPTOR
CHEMOSYMPATHECTOMY|CHEMOSYMPATHECTOMIES
CHEMOTAXIS|CHEMOTAXI
CHEMOTHERAPEUTIC|ANTINEOPLASTIC
CHEMOTHERAPIES|CHEMOTHER
CHEMOTHERAPY|CHEMOTHER
CHENIQUE|CHENIC
CHENODEOXYCHOLIC|CHENODEOXYCHOLATE
CHERUBISMS|CHERUBISM
CHEST|THORACE
CHESTS|THORACE
CHIARIS|CHIARI
CHIASMA|CHIASM
CHIASMS|CHIASM
CHICANOS|CHICANO
CHICKENS|CHICKEN
CHIGGERS|CHIGGER
CHILBLAINS|CHILBLAIN
CHILDBIRTHS|CHILDBIRTH
CHILDHOOD|CHILD
CHILDREN|CHILD
CHILDRENS|CHILD
CHILDS|CHILD
CHIMERAS|CHIMERA
CHIMPANZEE|CHIMPANSEE
CHIMPANZEES|CHIMPANSEE
CHINCAPS|CHINCAP
CHINCHILLAS|CHINCHILLA
CHINS|CHIN
CHIPMUNKS|CHIPMUNK
CHIROPRACTICS|CHIROPRACTIC
CHIROPTERAS|CHIROPTERA
CHLAMYDIALES|CHLAMYDIAL
CHLAMYDIAS|CHLAMYDIA
CHLOASMAS|CHLOASMA
CHLODITHANE|CHLODITAN
CHLORACETOPHONE|CHLORACETOPHON
CHLORAMINE|CHLORAMIN
CHLORAMINES|CHLORAMIN
CHLORANIFORMETHANE|CHLORANIFORMETHAN
CHLORATES|CHLORATE
CHLORAZEPATE|CHLORAZEPAT
CHLORAZOLE|CHLORAZOL
CHLORCHINALDOL|CHLORCHINALDINE
CHLORFENVINPHOS|CHLORFENVINFOS
CHLORHYDRINS|CHLORHYDRIN
CHLORIDES|CHLORIDE
CHLORINE|CHLORIN
CHLORLINCOCIN|CHLOLINCOCIN
CHLORMADINONE|CHLORMADINON
CHLOROACETOPHENONE|CHLORACETOPHENONE
CHLOROAMPHETAMINE|CHLORAMPHETAMINE
CHLOROBENZENES|CHLOROBENZENE
CHLOROBENZOATES|CHLOROBENZOATE
CHLOROBENZOIC|CHLOROBENZOATE
CHLOROBENZYLIDENEMALONITRILE|CHLOROBENZYLIDENE
CHLOROCYCLIZIN|CHLORCYCLIZINE
CHLOROGUANIDE|CHLORGUANID
CHLOROHYDRIN|CHLORHYDRIN
CHLOROHYDRINS|CHLORHYDRIN
CHLOROMERCURIBENZOATES|CHLOROMERCURIBENZOATE
CHLOROMERCURY|CHLOROMERCURI
CHLOROMETHAMPHETAMINE|CHLORMETHAMPHETAMINE
CHLOROMETHANES|CHLOROMETHANE
CHLOROMETHYLAMPHETAMINE|CHLORMETHAMPHETAMINE
CHLOROPHENOLS|CHLOROPHENOL
CHLOROPHENYLACETIC|CHLOROPHENYLACETATE
CHLOROPHOS|CHLOROFOS
CHLOROPHYLLIDES|CHLOROPHYLLIDE
CHLOROPLASTS|CHLOROPLAST
CHLOROPROPIONIC|CHLOROPROPIONATE
CHLOROQUINE|CHLOROCHIN
CHLORPHENVINFOS|CHLORFENVINFOS
CHLORPHENVINPHOS|CHLORFENVINFOS
CHLORPROTIXEN|CHLORPROTHIXENE
CHLORQUINALDOL|CHLOROQUINALDOL
CHLORTETRACYCLINE|CHLOROTETRACYCLINE
CHLORTHIAZID|CHLOROTHIAZIDE
CHOCOLATES|CHOCOLATE
CHOICES|CHOICE
CHOKINGS|CHOKING
CHOLANES|CHOLAN
CHOLANGIOGRAPHY|CHOLANGIOGRAPHIES
CHOLANGIOMAS|CHOLANGIOMA
CHOLANGIOPANCREATOGRAPHY|CHOLANGIOPANCREATOGRAPHIES
CHOLANGITIDES|CHOLANGIITIS
CHOLANGITIS|CHOLANGIITIS
CHOLANOIC|CHOLANIC
CHOLATES|CHOLATE
CHOLECALCIFEROLS|CHOLECALCIFEROL
CHOLECYSTECTOMY|CHOLECYSTECTOMIES
CHOLECYSTITIS|CHOLECYSTITIDES
CHOLECYSTOGRAPHY|CHOLECYSTOGRAPHIES
CHOLECYSTOSTOMY|CHOLECYSTOSTOMIES
CHOLEDOCHODUODENOSTOMY|CHOLEDOCHODUODENOSTOMIES
CHOLEDOCHOLITHIASIS|CHOLEDOCHOLITHIASES
CHOLEDOCHOSTOMY|CHOLEDOCHOSTOMIES
CHOLEDOCHUS|CHOLEDOCHAL
CHOLELITHIASIS|CHOLELITHIASES
CHOLENES|CHOLEN
CHOLERAS|CHOLERA
CHOLESTADIENES|CHOLESTADIEN
CHOLESTANE|CHOLESTAN
CHOLESTANES|CHOLESTAN
CHOLESTANOLS|CHOLESTANOL
CHOLESTASIS|CHOLESTASES
CHOLESTEATOMAS|CHOLESTEATOMA
CHOLESTENES|CHOLESTEN
CHOLESTENONES|CHOLESTENONE
CHOLESTERYL|CHOLESTEROL
CHOLINESTERASES|CHOLINESTERASE
CHOLINOCEPTORS|CHOLINOCEPTOR
CHONDROBLASTOMAS|CHONDROBLASTOMA
CHONDROCALCINOSIS|CHONDROCALCINOSES
CHONDRODYSPLASIAS|CHONDRODYSPLASIA
CHONDROITINASES|CHONDROITINASE
CHONDROMAS|CHONDROMA
CHONDROMATOSIS|CHONDROMATOSES
CHONDROMETAPLASIAS|CHONDROMETAPLASIA
CHONDRONECTINS|CHONDRONECTIN
CHONDROSARCOMAS|CHONDROSARCOMA
CHORDATAS|CHORDATA
CHORDATES|CHORDATE
CHORDOMAS|CHORDOMA
CHORDOTOMY|CHORDOTOMIES
CHOREAS|CHOREA
CHORIOADENOMAS|CHORIOADENOMA
CHORIOAMNIONITIS|CHORIOAMNIONITIDES
CHORIOCARCINOMAS|CHORIOCARCINOMA
CHORIOMENINGITIDES|CHORIOMENING
CHORIOMENINGITIS|CHORIOMENING
CHORIONIC|CHORION
CHORIONS|CHORION
CHORIORETINITIS|CHORIORETINITIDES
CHORISTOMAS|CHORISTOMA
CHOROIDAL|CHOROID
CHOROIDEREMIAS|CHOROIDEREMIA
CHOROIDITIS|CHOROIDITIDES
CHOROIDS|CHOROID
CHOSENS|CHOSEN
CHRISTIANITY|CHRISTIANITIES
CHROMATES|CHROMATE
CHROMATIDS|CHROMATID
CHROMATINS|CHROMATIN
CHROMATOGRAPHY|CHROMATOGRAPHIES
CHROMATOPHORES|CHROMATOPHORE
CHROMOBLASTOMYCOSIS|CHROMOBLASTOMYCOSES
CHROMOGRANINS|CHROMOGRANIN
CHROMOMYCINS|CHROMOMYCIN
CHROMOMYCOSIS|CHROMOMYCOSES
CHROMONES|CHROMONE
CHROMOSOME|CHROMOSOMAL
CHROMOSOMES|CHROMOSOMAL
CHRONAXY|CHRONAXIES
CHRONOBIOLOGIES|CHRONOBIOL
CHRONOBIOLOGY|CHRONOBIOL
CHRONOLOGY|CHRONOLOGIES
CHRYSENES|CHRYSENE
CHRYSINE|CHRYSIN
CHYLES|CHYLE
CHYLOMICRONS|CHYLOMICRON
CHYLOPERITONEUMS|CHYLOPERITONEUM
CHYLOTHORAXS|CHYLOTHORAX
CHYLUS|CHYLI
CICATRIX|CICATRICES
CILIAS|CILIA
CIMICES|CIMEX
CINEANGIOGRAPHY|CINEANGIOGRAPHIES
CINEFLUOROGRAPHY|CINEFLUOROGRAPHIES
CINERADIOGRAPHIES|CINERADIOGR
CINERADIOGRAPHY|CINERADIOGR
CINEREUMS|CINEREUM
CINGULI|CINGULATE
CINNAMATES|CINNAMATE
CINNAMONS|CINNAMON
CIRCLES|CIRCLE
CIRCULATION|CIRCULAT
CIRCULATIONS|CIRCULAT
CIRCUMCISIONS|CIRCUMCISION
CIRCUMSCRIBED|CIRCUMSCRIBE
CIRCUMSTANCES|CIRCUMSTANCE
CIRRHOSIS|CIRRHOSES
CISTAPHOS|CISTAFOS
CISTERNOGRAPHY|CISTERNOGRAPHIES
CISTRONS|CISTRON
CITICOLINE|CITICHOLINE
CITRATES|CITRATE
CIVILIZATIONS|CIVILIZATION
CLAIMS|CLAIM
CLAIRVOYANCES|CLAIRVOYANCE
CLAMPING|CLAMP
CLAMPINGS|
CLAMP
CLAMPS|CLAMP
CLAMS|CLAM
CLASSES|CLASS
CLASSIFICATIONS|CLASSIFICATION
CLAUDICATIONS|CLAUDICATION
CLAUSTROPHOBIAS|CLAUSTROPHOBIA
CLAVICLES|CLAVICLE
CLAVULONES|CLAVULONE
CLAWS|CLAW
CLEARANCES|CLEARANCE
CLEAVAGES|CLEAVAGE
CLEFTS|CLEFT
CLERGY|CLERGIES
CLERKSHIPS|CLERKSHIP
CLIENTS|CLIENT
CLIMACTERICS|CLIMACTERIC
CLIMATES|CLIMATE
CLINICIANS|CLINICIAN
CLINICS|CLINIC
CLINOXACIN|CINOXACIN
CLIPS|CLIP
CLITORIS|CLITORI
CLOACAS|CLOACA
CLOBENOSIDE|CLOBENOSID
CLOCKS|CLOCK
CLODANOLENE|CLODANOLEN
CLOMIPHENE|CLOMIFEN
CLOMIPRAMINE|CHLOMIPRAMINE
CLONINGS|CLONING
CLONORCHIASIS|CLONORCHIASES
CLORANFENICOL|CHLORAMPHENICOL
CLORAZEPATE|CHLORAZEPAT
CLORGILIN|CHLORGYLINE
CLORGYLINE|CHLORGYLINE
CLORPROPAMID|CHLORPROPAMIDE
CLOSURE|CLOSED
CLOSURES|CLOSED
CLOTHINGS|CLOTHING
CLOTIAPINE|CLOTHIAPINE
CLOTURINE|CLOTURIN
CLOUDY|CLOUDING
CLOVES|CLOVE
CLUBFOOTS|CLUBFOOT
CLUBS|CLUB
CLUSTERINGS|CLUSTERING
CLUSTERS|CLUSTER
CMHCS|CMHC
COAGULANTS|COAGULANT
COAGULATIONS|COAGULATION
COAGULOGENS|COAGULOGEN
COAGULOPATHY|COAGULOPATHIES
COALITIONS|COALITION
COALS|COAL
COAMIDE|COAMID
COARCTATIONS|COARCTATION
COBALAMINS|COBALAMIN
COBAMIDES|COBAMIDE
COCARCINOGENESIS|COCARCINOGENESES
COCCIDIOIDOMYCOSIS|COCCIDIOIDOMYCOSES
COCCIDIOSIS|COCCIDIOSES
COCCUS|COCCI
COCCYX|COCCYGEAL
COCCYXS|COCCYGEAL
COCHLEARI|COCHLEAR
COCHLEARIS|COCHLEAR
COCHLEAS|COCHLEA
COCKROACHE|COCKROACH
COCKROACHES|COCKROACH
COCOANUTS|COCOANUT
COCOAS|COCOA
COCONUT|COCOANUT
COCONUTS|COCOANUT
COCOS|COCO
CODES|CODE
CODINGS|CODING
COELENTERATAS|COELENTERATA
COENDU|COENDOUS
COENDUS|COENDOUS
COENURIASIS|COENURIASES
COENZYMES|COENZYME
COERCIONS|COERCION
COERULEUS|CAERULEUS
COFFEAS|COFFEA
COFFEE|COFFEA
COFFEES|COFFEA
COGNITIONS|COGNITION
COGNITIVE|COGNITION
COKES|COKE
COLCEMIDE|COLCEMID
COLDS|COLD
COLECTOMY|COLECTOMIES
COLEOPTERAS|COLEOPTERA
COLESTYRAMIN|CHOLESTYRAMINE
COLESTYRAMINE|CHOLESTYRAMINE
COLICINES|COLICIN
COLICINS|COLICIN
COLINIS|COLINI
COLINUS|COLINI
COLIPASES|COLIPASE
COLIPHAGES|COLIPHAGE
COLITIS|COLITIDES
COLLAPSE|COLLAPS
COLLECTINGS|COLLECTING
COLLECTIONS|COLLECTION
COLLEGE|ACAD
COLLINS|COLLIN
COLLOIDS|COLLOID
COLOBOMAS|COLOBOMA
COLOBUS|COLOBU
COLONIC|COLON
COLONOSCOPY|COLONOSCOPIES
COLONS|COLON
COLONY|COLONIES
COLORANTS|COLORANT
COLORIMETRY|COLORIMETRIES
COLORS|COLOR
COLOSTOMY|COLOSTOMIES
COLOSTRUMS|COLOSTRUM
COLPOHYSTERECTOMY|COLPOHYSTERECTOMIES
COLPOSCOPY|COLPOSCOPIES
COLPOTOMY|COLPOTOMIES
COLUS|COLI
COMAS|COMA
COMATOSE|COMA
COMBINATIONS|COMBINATION
COMBINED|COMBINATION
COMBS|COMB
COMMERCES|COMMERCE
COMMISSIONS|COMMISSION
COMMITMENTS|COMMITMENT
COMMITTEES|COMMITTEE
COMMUNICATIONS|COMMUNICATION
COMMUNICATIVE|COMMUNICATION
COMMUNISMS|COMMUNISM
COMMUNITY|COMMUNITIES
COMORBIDITY|COMORBIDITIES
COMOROS|COMORO
COMPARISONS|COMPARISON
COMPARTMENTATIONS|COMPARTMENTATION
COMPARTMENTS|COMPARTMENT
COMPATIBILITY|COMPATIBILITIES
COMPATIBLE|BIOCOMPATIBLE
COMPENSATIONS|COMPENSATION
COMPENSATIVE|COMPENSATED
COMPETENCE|ABILITIES
COMPETENCES|ABILITIES
COMPETITIONS|COMPETITION
COMPLAMINE|COMPLAMIN
COMPLEMENTS|COMPLEMENT
COMPLEXES|COMPLEX
COMPLIANCES|COMPLIANCE
COMPLICATION|COMPLICATED
COMPLICATIONS|COMPLICATED
COMPLICES|COMPLEX
COMPONENTS|COMPONENT
COMPOSITIONS|COMPOSITION
COMPOUNDS|COMPOUND
COMPRESSIONS|COMPRESSION
COMPUTER|COMPUTED
COMPUTERIZED|COMPUTED
COMPUTERS|COMPUTED
COMPUTINGS|COMPUTING
CONCENTRATES|CONCENTRATE
CONCENTRATIONS|CONCENTRATION
CONCEPTIONS|CONCEPTION
CONCEPTS|CONCEPT
CONCUSSIONS|CONCUSSION
CONDIMENTS|CONDIMENT
CONDITION|COND
CONDITIONINGS|CONDITIONING
CONDITIONS|COND
CONDOMS|CONDOM
CONDUCTANCES|CONDUCTANCE
CONDUCTIONS|CONDUCTION
CONDUCTIVE|CONDUCT
CONDUCTIVITY|CONDUCTIVITIES
CONDUCTOMETRY|CONDUCTOMETRIES
CONDYLES|CONDYLE
CONES|CONE
CONFERENCES|CONFERENCE
CONFIDENTIALITIES|PRIVACIES
CONFIDENTIALITY|PRIVACIES
CONFLICTS|CONFLICT
CONFORMATIONS|CONFORMATION
CONFORMITY|CONFORMITIES
CONFUSIONS|CONFUSION
CONGENITA|CONGEN
CONGENITAL|CONGEN
CONGENITALE|CONGEN
CONGENITAS|CONGEN
CONGESTIONS|CONGESTION
CONGRESSES|CONGRESSE
CONJUGATED|CONJUGATE
CONJUGATES|CONJUGATE
CONJUGATIONS|CONJUGATION
CONJUNCTIVAL|CONJUNCTIVA
CONJUNCTIVAS|CONJUNCTIVA
CONJUNCTIVITIS|CONJUNCTIVITIDES
CONNECTION|RELAT
CONNS|CONN
CONSANGUINITY|CONSANGUINITIES
CONSCIENCES|CONSCIENCE
CONSCIOUSNESSES|CONSCIOUSNESS
CONSENTS|CONSENT
CONSERVATIONS|CONSERVATION
CONSERVATISMS|CONSERVATISM
CONSTIPATIONS|CONSTIPATION
CONSTITUTIONS|CONSTITUTION
CONSTRICTIONS|CONSTRICTION
CONSTRICTIVE|CONSTRICTIV
CONSTRUCTIONS|CONSTRUCTION
CONSULTANTS|CONSULTANT
CONSULTATIONS|CONSULTATION
CONSUMMATIONS|CONSUMMATION
CONSUMPTIONS|CONSUMPTION
CONTACTINS|CONTACTIN
CONTAGIOSUM|INFECT
CONTAGIOSUMS|INFECT
CONTAGIOUS|INFECT
CONTAINERS|CONTAINER
CONTAINMENTS|CONTAINMENT
CONTAMINATION|ADULTERATION
CONTAMINATIONS|ADULTERATION
CONTENTS|CONTENT
CONTINUATIONS|CONTINUATION
CONTINUED|CONTINTUED
CONTINUITY|CONTINUITIES
CONTRACEPTIONS|CONTRACEPTION
CONTRACEPTIVE|CONTRACEPTION
CONTRACEPTIVES|CONTRACEPTION
CONTRACTILITY|CONTRACTILITIES
CONTRACTIONS|CONTRACTION
CONTRACTURES|CONTRACTURE
CONTRAINDICATION|CONTRAIND
CONTRAINDICATIONS|CONTRAIND
CONTROLS|CONTROL
CONTUSIONS|CONTUSION
CONVALESCENCES|CONVALESCENCE
CONVERGENCES|CONVERGENCE
CONVERSIONS|CONVERSION
CONVULSIONS|CONVULSION
COOKERY|COOKERIES
COOLEYS|COOLEY
COOPERATIONS|COOPERATION
COORDINATIONS|COORDINATION
COPDS|COPD
COPROPHAGIAS|COPROPHAGIA
COPROPORPHYRINOGENS|COPROPORPHYRINOGEN
COPROPORPHYRINS|COPROPORPHYRIN
COPULATIONS|COPULATION
COPULINS|COPULIN
COPYRIGHTS|COPYRIGHT
COR|CARDIAC
CORAMINE|CORAMIN
CORAZOL|CORASOL
CORAZOLE|CORASOL
CORDIS|CORDI
CORDS|CORD
CORIS|CORI
CORNEAL|CORNEA
CORNEAS|CORNEA
CORNS|CORN
CORONARY|CARDIAC
CORONAVIRUSES|CORONAVIRUS
CORONERS|CORONER
CORPORATIONS|CORPORATION
CORPS|CORP
CORPSE|CADAVER
CORPUS|CORPORA
CORPUSCLES|CORPUSCLE
CORPUSCULAR|CELL
CORRELATIONS|CORRELATION
CORRESPONDENCES|CORRESPONDENCE
CORRINOIDS|CORRINOID
CORROSIONS|CORROSION
CORTEXES|CORTEX
CORTICAL|CORTEX
CORTICES|CORTEX
CORTICOIDS|CORTICOID
CORTICOSTEROID|STEROID
CORTICOSTEROIDS|STEROID
CORTIS|CORTI
COSMETICS|COSMETIC
COSMIDS|COSMID
COSTACLAVINE|COSTACLAVIN
COSTENS|COSTEN
COSTS|COST
COTTONS|COTTON
COTTONSEEDS|COTTONSEED
COTURNIX|COTURNICES
COUGHING|COUGH
COUGHS|COUGH
COUMARIN|COUMADIN
COUMARINS|COUMADIN
COUMERMYCINS|COUMERMYCIN
COUMPOUND|COMPOUND
COUNCILS|COUNCIL
COUNSELING|PSYCHOTHER
COUNSELINGS|PSYCHOTHER
COUNSELORS|COUNSELOR
COUNTERIMMUNOELECTROPHORESIS|COUNTERIMMUNOELECTROPHORESES
COUNTERS|COUNTER
COUNTERSHOCKS|COUNTERSHOCK
COUNTINGS|COUNTING
COUNTRY|COUNTRIES
COUNTS|COUNT
COUNTY|COUNTIES
COUPLES|COUPLE
COUPONS|COUPON
COURSES|COURSE
COURTSHIPS|COURTSHIP
COW|BOVINE
COWDENS|COWDEN
COWPERS|COWPER
COXARTHROSIS|COXARTHROSES
COXSACKIEVIRUSES|COXSACKIEVIRUS
CRABS|CRAB
CRAMPS|CRAMP
CRANIOLOGY|CRANIOLOGIES
CRANIOMETRY|CRANIOMETRIES
CRANIOPHARYNGIOMAS|CRANIOPHARYNGIOMA
CRANIOSYNOSTOSES|CRANIOSYNOSTOSE
CRANIOSYNOSTOSIS|CRANIOSYNOSTOSE
CRANIOTOMY|CRANIOTOMIES
CRANIUM|CRANIAL
CRANIUMS|CRANIAL
CRAYFISHS|CRAYFISH
CREAMS|CREAM
CREATIVENESSES|CREATIVENESS
CREDENTIALINGS|CREDENTIALING
CREDITS|CREDIT
CREMATIONS|CREMATION
CREMOPHORE|CREMOPHOR
CRESOLS|CRESOL
CRESTS|CREST
CRETINISMS|CRETINISM
CRIBS|CRIB
CRICETIDAE|CRICETID
CRICETIDS|CRICETID
CRICETINUS|CRICETINI
CRICKETS|CRICKET
CRIMES|CRIME
CRIMINOLOGY|CRIMINOLOGIES
CRISIS|CRISES
CRITERIAS|CRITERIA
CRITIQUES|CRITIQUE
CROAKERS|CROAKER
CROCODILES|CROCODILE
CROHNS|CROHN
CROPS|CROP
CROSSES|CROSS
CROSSMATCHINGS|CROSSMATCHING
CROSSOVERS|CROSSOVER
CROUPS|CROUP
CROUZONS|CROUZON
CROWDINGS|CROWDING
CROWNS|CROWN
CRUORS|CRUOR
CRUSHS|CRUSH
CRUSTACEAS|CRUSTACEA
CRUTCHE|CRUTCH
CRUTCHES|CRUTCH
CRYING|CRY
CRYINGS|CRY
CRYOANESTHESIAS|CRYOANESTHESIA
CRYOGLOBULINEMIAS|CRYOGLOBULINEMIA
CRYOGLOBULINS|CRYOGLOBULIN
CRYOPROTEINS|CRYOPROTEIN
CRYOSURGERIES|CRYOSURG
CRYOSURGERY|SURG
CRYOTHERAPEUTIC|CRYOTHER
CRYOTHERAPIES|CRYOTHER
CRYOTHERAPY|CRYOTHER
CRYPTOCOCCOSIS|CRYPTOCOCCOSES
CRYPTORCHISMS|CRYPTORCHISM
CRYPTOSPORIDIOSIS|CRYPTOSPORIDIOSES
CRYSTALLINS|CRYSTALLIN
CRYSTALLIZATIONS|CRYSTALLIZATION
CRYSTALLOGRAPHY|CRYSTALLOGRAPHIES
CSF|CEREBROSP
CUCUMBERS|CUCUMBER
CUCURBITACINS|CUCURBITACIN
CUES|CUE
CULDOSCOPES|CULDOSCOPE
CULDOSCOPY|CULDOSCOPIES
CULICES|CULEX
CULICOIDES|CULICOIDE
CULTIVATIONS|CULTIVATION
CULTS|CULT
CULTURES|CULTURE
CURANTYL|CURANTIL
CURETTAGES|CURETTAGE
CURIOSITY|CURIOSITIES
CURLINGS|CURLING
CURRICULUM|CURRICULA
CURSES|CURSE
CURVATURES|CURVATURE
CURVES|CURVE
CUSHINGS|CUSHING
CUSPIDS|CUSPID
CUSTODY|CUSTODIES
CUSTOMS|CUSTOM
CUTANEOUS|DERMATOLOGIC
CUTICLES|CUTICLE
CYALUME|CYALUM
CYANATES|CYANATE
CYANIDES|CYANIDE
CYANOACRYLATES|CYANOACRYLATE
CYANOSIS|CYANOSES
CYBERNETICS|CYBERNETIC
CYCLACILLIN|CICLACILLIN
CYCLAMATES|CYCLAMATE
CYCLE|CYCL
CYCLES|CYCL
CYCLIC|CYCL
CYCLICITY|CYCLICITIES
CYCLING|CYCL
CYCLINGS|CYCL
CYCLITIS|CYCLITIDES
CYCLIZATIONS|CYCLIZATION
CYCLOBUTANES|CYCLOBUTANE
CYCLODEXTRINS|CYCLODEXTRIN
CYCLOHEXANES|CYCLOHEXANE
CYCLOHEXANOLS|CYCLOHEXANOL
CYCLOHEXANONES|CYCLOHEXANONE
CYCLOHEXYLAMINES|CYCLOHEXYLAMINE
CYCLOPENTANES|CYCLOPENTANE
CYCLOPHENIL|CYCLOFENIL
CYCLOPROPANES|CYCLOPROPANE
CYCLOSPORINE|CYCLOSPORIN
CYCLOSPORINES|CYCLOSPORIN
CYCLOSPORINS|CYCLOSPORIN
CYCLOSTOMES|CYCLOSTOME
CYCLOTRONS|CYCLOTRON
CYGNOLINE|CYGNOLIN
CYLINDROMAS|CYLINDROMA
CYMARINE|CYMARIN
CYNARINE|CYNARIN
CYPRINODONS|CYPRINODON
CYPRINODONTIDS|CYPRINODONTID
CYPRINODONTIFORMES|CYPRINODONTIFORME
CYSTADENOCARCINOMAS|CYSTADENOCARCINOMA
CYSTADENOMAS|CYSTADENOMA
CYSTAFOS|CISTAFOS
CYSTAPHOS|CISTAFOS
CYSTATINS|CYSTATIN
CYSTECTOMY|CYSTECTOMIES
CYSTEINYL|CYSTEINE
CYSTICAS|CYSTICA
CYSTICERCOSIS|CYSTICERCOSES
CYSTINAMIN|CYSTAMINE
CYSTINE|CYSTEINE
CYSTINOSIS|CYSTINOSES
CYSTINURIAS|CYSTINURIA
CYSTITIS|CYSTITIDES
CYSTOCELES|CYSTOCELE
CYSTOIDES|CYSTOID
CYSTOLITHS|CYSTOLITH
CYSTOPYELITIS|CYSTOPYELITIDES
CYSTOSCOPY|CYSTOSCOPIES
CYSTOSTOMY|CYSTOSTOMIES
CYSTS|CYST
CYTALOPRAM|CITALOPRAM
CYTAPHERESIS|CYTAPHERESES
CYTICHOLINE|CITICHOLINE
CYTOCHALASINS|CYTOCHALASIN
CYTOCHEMICAL|CYTOCHEM
CYTOCHEMISTRY|CYTOCHEM
CYTOCHROME|CYTOCHROMC
CYTOCHROMES|CYTOCHROMC
CYTODIAGNOSES|CYTODIAG
CYTODIAGNOSIS|CYTODIAG
CYTOFLUOROMETRY|CYTOFLUOROMETRIES
CYTOGENETICS|CYTOGENET
CYTOKINES|CYTOKINE
CYTOKINESIS|CYTOKINESES
CYTOKINETICS|CYTOKINETIC
CYTOKININS|CYTOKININ
CYTOLIPINS|CYTOLIPIN
CYTOLOGIC|CYTOL
CYTOLOGICAL|CYTOL
CYTOLOGY|CYTOL
CYTOLYSINS|CYTOLYSIN
CYTOMEGALIC|CYTOMEGAL
CYTOMEGALOVIRUSES|CYTOMEGALOVIRUS
CYTOMETRY|CYTOMETRIES
CYTOPATHOGEN|CYTOPATHIC
CYTOPATHOGENIC|CYTOPATHIC
CYTOPENIAS|CYTOPENIA
CYTOPHOTOMETRY|CYTOPHOTOMETRIES
CYTOPLASMS|CYTOPLASM
CYTOSKELETONS|CYTOSKELETON
CYTOSOLS|CYTOSOL
CYTOTOXIC|CYTOTOX
CYTOTOXICITIES|CYTOTOX
CYTOTOXICITY|CYTOTOX
CYTOTOXINS|CYTOTOXIN
DABEQUINE|DABEQUIN
DACRYOCYSTITIS|DACRYOCYSTITIDES
DACRYOCYSTORHINOSTOMY|DACRYOCYSTORHINOSTOMIES
DACRYOCYSTOSTOMY|DACRYOCYSTOSTOMIES
DAIRYINGS|DAIRYING
DAMAGES|DAMAGE
DANCINGS|DANCING
DANTHRONE|DANTHRON
DAPHNIAS|DAPHNIA
DARIERS|DARIER
DARKNESS|DARK
DARKNESSES|DARK
DATABANKS|DATABANK
DATABASES|DATABASE
DATAPHONES|DATAPHONE
DATES|DATE
DAUGHTERS|DAUGHTER
DAUNOBLASTINE|DAUNOBLASTIN
DDBPS|DDBP
DEAFNESSES|DEAFNESS
DEALKYLATIONS|DEALKYLATION
DEAMINASES|DEAMINASE
DEAMINATIONS|DEAMINATION
DEATHS|DEATH
DEBRIDEMENTS|DEBRIDEMENT
DEBRISOQUINE|DEBRISOQUIN
DECALCIFICATIONS|DECALCIFICATION
DECAMETHOXINE|DECAMETHOXIN
DECANOATES|DECANOATE
DECARBAZINE|DACARBAZINE
DECARBOXYLASES|DECARBOXYLASE
DECARBOXYLATIONS|DECARBOXYLATION
DECELERATIONS|DECELERATION
DECEPTIONS|DECEPTION
DECIDUAS|DECIDUA
DECISIONS|DECISION
DECLINES|DECLINE
DECOMPRESSIONS|DECOMPRESSION
DECONTAMINATIONS|DECONTAMINATION
DECORTICATIONS|DECORTICATION
DECREASED|DECREASE
DECREASES|DECREASE
DECUBITUS|DECUBITI
DECUSSATIONS|DECUSSATION
DEDICATIONS|DEDICATION
DEEPENING|DEEP
DEERS|DEER
DEFECATIONS|DEFECATION
DEFECTS|DEFECT
DEFENSES|DEFENSE
DEFENSINS|DEFENSIN
DEFIBRILLATIONS|DEFIBRILLATION
DEFICIENCIES|DEFIC
DEFICIENCY|DEFIC
DEFORESTATIONS|DEFORESTATION
DEFORMABILITY|DEFORMABILITIES
DEFORMANS|DEFORMAN
DEFORMITITES|DEFORMITIES
DEFORMITY|DEFORMITIES
DEGENERATIONS|DEGENERATION
DEGLUTITIONS|DEGLUTITION
DEGLYCYRRHIZINIZED|DEGLYCYRRHIZINATED
DEGRANOL|DECRANOL
DEGUS|DEGU
DEHISCENCES|DEHISCENCE
DEHYDRASES|DEHYDRASE
DEHYDRATASE|DEHYDRASE
DEHYDRATASES|DEHYDRASE
DEHYDRATIONS|DEHYDRATION
DEHYDROCHOLESTEROLS|DEHYDROCHOLESTEROL
DEHYDROGENASES|DEHYDROGENASE
DEINSTITUTIONALIZATIONS|DEINSTITUTIONALIZATION
DEITERS|DEITER
DEITIFORINE|DEITIFORIN
DEKARIS|DECARIS
DELAY|DELAIES
DELAYED|DELAIES
DELEAGES|DELEAGE
DELETIONS|DELETION
DELINQUENCY|DELINQUENCIES
DELIRIUMS|DELIRIUM
DELIVERY|DELIVERIES
DELUSIONS|DELUSION
DEMANDS|DEMAND
DEMENTIAS|DEMENTIA
DEMETHYLASES|DEMETHYLASE
DEMOCRACY|DEMOCRACIES
DEMOGRAPHERS|DEMOGRAPHER
DEMOGRAPHIES|DEMOGRAPHICS
DEMOGRAPHY|DEMOGRAPHICS
DEMYELINATIONS|DEMYELINATION
DENATURATIONS|DENATURATION
DENDRITES|DENDRITE
DENDRODOCHINE|DENDRODOCHIN
DENERVATIONS|DENERVATION
DENGUES|DENGUE
DENS|DEN
DENSITOMETRY|DENSITOMETRIES
DENSITY|DENSITIES
DENT|TEETH
DENTAL|TEETH
DENTES|DENTE
DENTICLES|DENTICLE
DENTIFRICES|DENTIFRICE
DENTINAL|DENTIN
DENTINE|DENTIN
DENTINOGENESIS|DENTINOGENESES
DENTINS|DENTIN
DENTISTRIES|TEETH
DENTISTRY|TEETH
DENTISTS|DENTIST
DENTITIONS|DENTITION
DENTURE|TEETH
DENTURES|TEETH
DENTURISTS|DENTURIST
DEODORANTS|DEODORANT
DEOXYADENOSINE|DEOXYADENOSIN
DEOXYADENOSINES|DEOXYADENOSIN
DEOXYHEMOGLOBIN|DEOXYGENATED
DEOXYRIBONUCLEASES|DEOXYRIBONUCLEASE
DEOXYRIBONUCLEOSIDES|DEOXYRIBONUCLEOSIDE
DEOXYURIDYLIC|DEOXYURIDYLATE
DEPARTMENT|AGENCIES
DEPARTMENTS|AGENCIES
DEPENDENCE|DEPEND
DEPENDENCES|DEPEND
DEPERSONALIZATIONS|DEPERSONALIZATION
DEPILATIONS|DEPILATION
DEPLETIONS|DEPLETION
DEPOSITIONS|DEPOSITION
DEPOSITS|DEPOSIT
DEPRECIATIONS|DEPRECIATION
DEPRESSANT|DEPRESS
DEPRESSANTS|DEPRESS
DEPRESSIONS|DEPRESSION
DEPRIVATIONS|DEPRIVATION
DEPT|AGENCIES
DEQUALINIUM|DECHALINIUM
DEQUALONUM|DECHALINIUM
DERCUMS|DERCUM
DERELICT|ABANDONED
DERIVATIVES|DERIVATIVE
DERMABRASIONS|DERMABRASION
DERMACENTORS|DERMACENTOR
DERMALONS|DERMALON
DERMATITIS|DERMATITIDES
DERMATOGLYPHICS|DERMATOGLYPHIC
DERMATOLOGICAL|DERMATOLOGIC
DERMATOLOGY|DERMATOLOGIES
DERMATOLYSIS|DERMATOLYSES
DERMATOMEGALY|DERMATOMEGALIES
DERMATOMYCOSES|DERMATOMYCOSE
DERMATOMYCOSIS|DERMATOMYCOSE
DERMATOMYOSITIS|DERMATOMYOSITIDES
DERMATOPHYTID|DERMAPHYTID
DERMATOPLASTY|DERMATOPLASTIES
DERMATOSCLEROSIS|DERMATOSCLEROSES
DERMATOSES|DERMATOSE
DERMATOSIS|DERMATOSE
DERMOIDS|DERMOID
DERMOTOXINS|DERMATOTOXINS
DESACETYLAMINOCOLCHINE|DESACETYLAMINOCOLCHICINE
DESACETYLMETHYLCOLCHINE|DESACETYLMETHYLCOLCHICINE
DESATURASES|DESATURASE
DESCRIPTIONS|DESCRIPTION
DESCYCLOPROPYLMETHYLPRAZEPAM|DESCYCLOPROPYLMETHYL
DESENSITIZATIONS|DESENSITIZATION
DESERTED|ABANDONED
DESFERROXAMINE|DEFEROXAMINE
DESGLUCOLANATOSIDES|DESGLUCOLANATOSIDE
DESICCATIONS|DESICCATION
DESIGNS|DESIGN
DESIRABILITY|DESIRABILITIES
DESMETHOXYDAUNORUBICIN|DEMETHOXYDAUNORUBICIN
DESMOIDS|DESMOID
DESMOLASES|DESMOLASE
DESMOSOMES|DESMOSOME
DESMOSTEROL|DEMOSTEROL
DESOXY|DEOXY
DESOXYADRENALINE|DEOXYADRENALINE
DESOXYRIBONUCLEASES|DESOXYRIBONUCLEASE
DESRIL|DESERIL
DESSICATION|DESICCATION
DESSICATIONS|DESICCATION
DESTINATIONS|DESTINATION
DESTRUCTIONS|DESTRUCTION
DESTRUCTIVENESS|AGGRESSIVE
DESYNCHRONIZATIONS|DESYNCHRONIZATION
DETACHMENTS|DETACHMENT
DETECTIONS|
DETECTION
DETERGENTS|DETERGENT
DETERMINANTS|DETERMINANT
DETERMINATIONS|DETERMINATION
DETOXICATION|DETOX
DETOXICATIONS|DETOX
DETOXIFICATION|DETOX
DETOXIFICATIONS|DETOX
DEUTERONS|DEUTERON
DEUTEROPORPHYRINS|DEUTEROPORPHYRIN
DEVELOPMENTAL|DEVELOPMENT
DEVELOPMENTS|DEVELOPMENT
DEVIANTS|DEVIANT
DEVIATIONS|DEVIATION
DEVICE|DEVIC
DEVICES|DEVIC
DEVITALIZATIONS|DEVITALIZATION
DEXBENZETIMIDE|DEXBENZETIMID
DEXTRANS|DEXTRAN
DEXTRINOSIS|DEXTRINOSES
DEXTROCARDIAS|
DEXTROCARDIA
DIABETES|DIABETE
DIABETIC|DIABETE
DIACYLGLYCEROLS|DIACYLGLYCEROL
DIAGENS|DIAGEN
DIAGNOSES|DIAG
DIAGNOSIS|DIAG
DIAGNOSTIC|DIAG
DIAGNOSTICS|DIAG
DIALENE|DIALEN
DIALYSATES|DIALYSATE
DIALYSES|DIALYSE
DIALYSIS|DIALYSE
DIALYZATES|DIALYSATE
DIAMINES|DIAMINE
DIAMINO|DIAMINE
DIAMINOPIMELIC|DIAMINOPIMELATE
DIAMONDS|DIAMOND
DIAMPHENETHIDE|DIAMFENETIDE
DIAPERS|DIAPER
DIAPHANOSCOPY|DIAPHANOSCOPIES
DIAPHORASES|DIAPHORASE
DIAPHRAGMATIC|DIAPHRAGM
DIAPHRAGMS|DIAPHRAGM
DIARRHEAS|DIARRHEA
DIARY|DIARIES
DIASTEMAS|DIASTEMA
DIASTEMATOMYELIAS|DIASTEMATOMYELIA
DIASTOLES|DIASTOLE
DIATHERMY|DIATHERMIES
DIATHESIS|DIATHESES
DIAZANE|DIAZAN
DIBENYLINE|DIBENYLENE
DIBENZANTHRACENES|DIBENZANTHRACENE
DIBENZAZEPINES|DIBENZAZEPINE
DIBENZOFURANS|DIBENZOFURAN
DIBENZOTHIEPINS|DIBENZOTHIEPIN
DIBENZYLINE|DIBENZYLIN
DIBENZYRAN|DIBENZIRAN
DIBOZANE|DIBOZAN
DIBROMIDES|DIBROMIDE
DIBROMOETHANES|DIBROMOETHANE
DICHLORIDES|DICHLORIDE
DICHLOROETHANES|DICHLOROETHANE
DICHLOROETHYLENES|DICHLOROETHYLENE
DICHLOROPHENE|DICHLOROPHEN
DICHROISMS|DICHROISM
DICLOFENAC|DICHLOFENAL
DICLOFENAMID|DICHLORPHENAMIDE
DICLOPHENAC|DICHLOFENAL
DICROCOELIASIS|DICROCOELIASES
DICROFENAC|DICHLOFENAL
DICTIONARY|DICTIONARIES
DICTYOCAULIASIS|DICTYOCAULIASES
DICTYOPTERAS|DICTYOPTERA
DIDELPHIS|DIDELPHI
DIDEOXYRIBONUCLEOSIDES|DIDEOXYRIBONUCLEOSIDE
DIDEOXYSHIKIMIC|DIDEOXYSHIKIMATE
DIDMOADS|DIDMOAD
DIENCEPHALONS|DIENCEPHALON
DIENTAMOEBIASIS|DIENTAMOEBIASES
DIES|DIE
DIESTERS|DIESTER
DIETHYLAMINES|DIETHYLAMINE
DIETS|DIET
DIFFERENCES|DIFFERENCE
DIFFERENTIAL|DIFFER
DIFFERENTIALS|DIFFER
DIFFERENTIATED|DIFFER
DIFFERENTIATION|DIFFER
DIFFERENTIATIONS|DIFFER
DIFFRACTIONS|DIFFRACTION
DIFFUSE|DIFFUS
DIFFUSIONS|DIFFUSION
DIFFUSUMS|DIFFUSUM
DIFLUOROFUMARIC|DIFLUOROFUMARATE
DIFLUOROMYRISTIC|DIFLUOROMYRISTATE
DIGESTIONS|DIGESTION
DIGITOXIN|DIGITALIS
DIGLYCERIDES|DIGLYCERIDE
DIGNITY|DIGNITIES
DIGOXIN|DIGITALIS
DIHYDRALLAZINE|DIHYDRALAZINE
DIHYDROAMBAZONE|DIHYDROAMBAZON
DIHYDRODIOLS|DIHYDRODIOL
DIHYDRODIPICOLINIC|DIHYDRODIPICOLINATE
DIHYDROERGOKRIPTIN|DIHYDROERGOCRYPTINE
DIHYDROERGOKRYSTIN|DIHYDROERGOCRISTINE
DIHYDROERGOTOXINE|DIHYDROERGOTOXIN
DIHYDROPYRIDINES|DIHYDROPYRIDINE
DIHYDROQUEUINYL|DIHYDROQUEUINE
DIHYDROXYBENZENES|DIHYDROXYBENZENE
DIHYDROXYCHOLECALCIFEROLS|DIHYDROXYCHOLECALCIFEROL
DIHYDROXYTRYPTAMINES|DIHYDROXYTRYPTAMINE
DIHYDROXYVITAMINS|DIHYDROXYVITAMIN
DIIODOTHYRONINES|DIIODOTHYRONINE
DIKETOPIPERAZINES|DIKETOPIPERAZINE
DILATATIONS|DILATATION
DILATION|DILATATION
DILEMMAS|DILEMMA
DIMENSIONS|DIMENSION
DIMERS|DIMER
DIMETHYLAMINES|DIMETHYLAMINE
DIMETHYLHYDRAZINES|DIMETHYLHYDRAZINE
DIMETHYLSILOXANES|DIMETHYLSILOXANE
DIMETHYLVALERIC|DIMETHYLVALERATE
DIMETIKON|DIMETICON
DIMOCIFONE|DIMOCIFON
DIMORPHISMS|DIMORPHISM
DIMPLING|DIMPLE
DIMYCOLATES|DIMYCOLATE
DINITROBENZENES|DINITROBENZENE
DINITROCRESOLS|DINITROCRESOL
DINITROPHENOLS|DINITROPHENOL
DINITROPHENYLACETIC|DINITROPHENYLACETATE
DIODOQUIN|DIIODOQUIN
DIOFLUBENZURON|DIFLUBENZURON
DIOLS|DIOL
DIOXANES|DIOXANE
DIOXETANES|DIOXETANE
DIOXINS|DIOXIN
DIOXOLANE|DIOXOLAN
DIOXOLANES|DIOXOLAN
DIOXOLES|DIOXOL
DIPEPTIDASES|DIPEPTIDASE
DIPEPTIDES|DIPEPTIDE
DIPHENYLHYDRAMIN|DIPHENHYDRAMINE
DIPHENYLHYDRAMINE|DIPHENHYDRAMINE
DIPHOSPHATAS|DIPHOSPHATA
DIPHOSPHATASE|DIPHOSPHATA
DIPHOSPHATES|
DIPHOSPHATE
DIPHOSPHOGLYCERIC|DIPHOSPHOGLYCERATE
DIPHOSPHOINOSITIDES|DIPHOSPHOINOSITIDE
DIPHOSPHOKINASES|DIPHOSPHOKINASE
DIPHOSPHONATES|DIPHOSPHONATE
DIPHOSPHONIC|DIPHOSPHONATE
DIPHTHERIAS|DIPHTHERIA
DIPHYLLOBOTHRIASIS|DIPHYLLOBOTHRIASES
DIPICRYLAMINE|DIPICRYLAMINATE
DIPINE|DIPIN
DIPLACINE|DIPLACIN
DIPLOIDY|DIPLOIDIES
DIPLOPIAS|DIPLOPIA
DIPODOMYS|DIPODOMY
DIPTERAS|DIPTERA
DIPYDOLOR|DIPIDOLOR
DIPYLIDIASIS|DIPYLIDIASES
DIRECT|CONJUGATE
DIRECTIVES|DIRECTIVE
DIRECTORS|DIRECTOR
DIRECTORY|DIRECTORIES
DIROFILARIASIS|DIROFILARIASES
DISABILITY|DISABILITIES
DISACCHARIDASES|DISACCHARIDASE
DISACCHARIDES|DISACCHARIDE
DISADVANTAGEMENTS|DISADVANTAGEMENT
DISARTICULATIONS|DISARTICULATION
DISASTERS|DISASTER
DISCHARGES|DISCHARGE
DISCIPLINES|DISCIPLINE
DISCITIS|DISCITIDES
DISCLOSURES|DISCLOSURE
DISCOIDINS|DISCOIDIN
DISCOLORATIONS|DISCOLORATION
DISCOLYSIS|DISCOLYSES
DISCRIMINATIONS|DISCRIMINATION
DISCS|DISC
DISEASES|DISEASE
DISEQUILIBRIUMS|DISEQUILIBRIUM
DISGERMINOMAS|DISGERMINOMA
DISINCENTIVES|DISINCENTIVE
DISINFECTANT|ANTISEPTIC
DISINFECTANTS|ANTISEPTIC
DISINFECTION|DISINFECT
DISINFECTIONS|DISINFECT
DISINTEGRATIONS|DISINTEGRATION
DISK|DISC
DISKITIDES|DISCITIDES
DISKITIS|DISCITIDES
DISKS|DISC
DISLOCATION|DISLOCATABLE
DISLOCATIONS|DISLOCATABLE
DISORDER|DISEASE
DISORDERS|DISEASE
DISORGANIZATIONS|DISORGANIZATION
DISPARITY|DISPARITIES
DISPENSATORIES|PHARM
DISPENSATORY|PHARM
DISPENSERS|DISPENSER
DISPERSION|DISPERSE
DISPERSIONS|DISPERSE
DISPLACEMENT|DISPLACED
DISPLACEMENTS|DISPLACED
DISPLAYS|DISPLAY
DISPOSALS|DISPOSAL
DISPOSITION|ATTITUDE
DISSECANS|DISSECAN
DISSECTION|DISSECTING
DISSECTIONS|DISSECTING
DISSEMINATED|DISSEM
DISSEMINATUS|DISSEM
DISSENTS|DISSENT
DISSERTATIONS|DISSERTATION
DISSOCIATIONS|DISSOCIATION
DISSONANCES|DISSONANCE
DISTAMYCINS|DISTAMYCIN
DISTANCES|DISTANCE
DISTEMPERS|DISTEMPER
DISTOLONE|DISTOLON
DISTORTIONS|DISTORTION
DISTRESSES|DISTRESS
DISTRIBUTIONS|DISTRIBUTION
DISTRICTS|DISTRICT
DISTURBANCES|DISTURBANCE
DISULFIDES|DISULFIDE
DISULFONATED|DISULFONATE
DISULFONIC|DISULFONATE
DITAZOLE|DITAZOL
DITHIADENE|DITHIADEN
DITHIOCARBAMATES|DITHIOCARBAMATE
DITHIOPROPANESULFATE|DIMERCAPTOPROPANE
DITHIZONE|DITHIZON
DIURESIS|DIURESES
DIURETICS|DIURETIC
DIVERSIFICATIONS|DIVERSIFICATION
DIVERSIONS|DIVERSION
DIVERSITY|DIVERSITIES
DIVERTICULA|DIVERTICULOSES
DIVERTICULAR|DIVERTICULOSES
DIVERTICULAS|DIVERTICULOSES
DIVERTICULITIDES|DIVERTICULOSES
DIVERTICULITIS|DIVERTICULOSES
DIVERTICULOSIS|DIVERTICULOSES
DIVERTICULUM|DIVERTICULOSES
DIVERTICULUMS|DIVERTICULOSES
DIVINGS|DIVING
DIVISIONS|DIVISION
DIVORCED|DIVORCE
DIVORCES|DIVORCE
DIZENEDICARBOXYLIC|DICARBOXYLIC
DIZZINESSES|DIZZINESS
DJIBOUTIS|DJIBOUTI
DJUNGARIANS|DJUNGARIAN
DNAASE|DEOXYRIBONUCLEASE
DNASE|DEOXYRIBONUCLEASE
DOCOSAHEXAENOATES|DOCOSAHEXAENOATE
DOCOSAHEXENOIC|DOCOSAHEXAENOIC
DOCTORS|DOCTOR
DOCUMENTATIONS|DOCUMENTATION
DOG|CANINE
DOGFISHS|DOGFISH
DOGS|CANINE
DOLLARS|DOLLAR
DOLPHINS|DOLPHIN
DOMESTICAS|DOMESTICA
DOMINANCES|DOMINANCE
DOMPERIDONE|DOMPERIDON
DONATIONS|DONATION
DONOR|DONATION
DONORS|DONATION
DONS|DON
DOPEGYT|DOPEGIT
DOPERGIT|DOPEGIT
DOPINGS|DOPING
DORMICES|DORMICE
DOSAGES|DOSAGE
DOSIMETRY|DOSIMETRIES
DOUCHINGS|DOUCHING
DOULOUREUXS|DOULOUREUX
DOURINES|DOURINE
DOUROUCOULUS|DOUROUCOULI
DOWNS|DOWN
DOWRY|DOWRIES
DOXYLSTEARIC|DOXYLSTEARATE
DRACUNCULOSIS|DRACUNCULOSES
DRAINAGES|DRAINAGE
DRAINS|DRAIN
DRAKEOLS|DRAKEOL
DRAMAS|DRAMA
DREAMS|DREAM
DREBRINS|DREBRIN
DRESSINGS|DRESSING
DRGS|DRG
DRIFTS|DRIFT
DRILLS|DRILL
DRINK|BEVERAGE
DRINKINGS|DRINKING
DRIPS|DRIP
DRIVE|DESIRE
DRIVES|DESIRE
DROMEDARY|DROMEDARIES
DRONTSIT|DRONCIT
DROOLINGS|DROOLING
DROPOUTS|DROPOUT
DROPS|DROP
DROSOPHILAS|DROSOPHILA
DROSOPTERINS|DROSOPTERIN
DROTAVERINE|DROTAVERIN
DROUGHTS|DROUGHT
DROWNINGS|DROWNING
DROWSINESSES|DROWSINESS
DRUG|AGENT
DRUGS|AGENT
DRUSENS|DRUSEN
DRYNESSES|DRYNESS
DUANES|DUANE
DUCKMOLES|DUCKMOLE
DUCKS|DUCK
DUCTAL|DUCT
DUCTS|DUCT
DUCTUS|DUCT
DUHRINGS|DUHRING
DUMPINGS|DUMPING
DUODENITIS|DUODENITIDES
DUODENOSCOPY|DUODENOSCOPIES
DUODENOSTOMY|DUODENOSTOMIES
DUODENUM|DUODENAL
DUODENUMS|DUODENAL
DUPLICATIONS|DUPLICATION
DUPUYTRENS|DUPUYTREN
DURATIONS|DURATION
DUSTS|DUST
DWARFISMS|DWARFISM
DYES|DYE
DYNAMICS|DYNAMIC
DYPHONATE|DYFONATE
DYPHYLLINE|DIPHYLLINE
DYSARTHRIAS|DYSARTHRIA
DYSAUTONOMIAS|DYSAUTONOMIA
DYSBETALIPOPROTEINEMIAS|DYSBETALIPOPROTEINEMIA
DYSCHONDROPLASIAS|DYSCHONDROPLASIA
DYSCRASIAS|DYSCRASIA
DYSEMBRYOMAS|DYSEMBRYOMA
DYSENTERY|DYSENTERIES
DYSFUNCTION|DYSFUNC
DYSFUNCTIONS|DYSFUNC
DYSGAMMAGLOBULINEMIAS|DYSGAMMAGLOBULINEMIA
DYSGENESIS|DYSGENESES
DYSGERMINOMA|DISGERMINOMA
DYSGERMINOMAS|DISGERMINOMA
DYSGEUSIAS|DYSGEUSIA
DYSIDENINE|DYSIDENIN
DYSKINESIAS|DYSKINESIA
DYSLEXIAS|DYSLEXIA
DYSMENORRHEAS|DYSMENORRHEA
DYSMOTILITY|DYSMOTILITIES
DYSOSTOSES|DYSOSTOSE
DYSOSTOSIS|DYSOSTOSE
DYSPAREUNIAS|DYSPAREUNIA
DYSPEPSIAS|DYSPEPSIA
DYSPHAGIAS|DYSPHAGIA
DYSPHASIAS|DYSPHASIA
DYSPHONIAS|DYSPHONIA
DYSPLASIA|DYSPL
DYSPLASIAS|DYSPL
DYSPNEAS|DYSPNEA
DYSPNOEA|DYSPNEA
DYSRAPHIAS|DYSRAPHIA
DYSRAPHISM|DYSRAPHIA
DYSRAPHISMS|DYSRAPHIA
DYSRHYTHMIA|ARRHYTHMIA
DYSRHYTHMIAS|ARRHYTHMIA
DYSRRHYTHMIA|ARRHYTHMIA
DYSSOMNIAS|DYSSOMNIA
DYSSYNERGIAS|DYSSYNERGIA
DYSTOCIAS|DYSTOCIA
DYSTONIAS|DYSTONIA
DYSTROPHICA|DYSTROPHIC
DYSTROPHIES|DYSTROPHIA
DYSTROPHY|DYSTROPHIA
EARACHES|EARACHE
EARS|
EAR
EARTHQUAKES|EARTHQUAKE
EARTHWORMS|EARTHWORM
EARWAX|CERUMEN
EASTERN|EAST
EATERS|EATER
EATINGS|EATING
EBSTEINS|EBSTEIN
ECCHYMOSIS|ECCHYMOSES
ECDYSTEROIDS|ECDYSTEROID
ECHIDNAS|ECHIDNA
ECHINOCOCCOSES|ECHINOCOCCIASIS
ECHINOCOCCOSIS|ECHINOCOCCIASIS
ECHINODERMATAS|ECHINODERMATA
ECHINOSTOMIASIS|ECHINOSTOMIASES
ECHOCARDIOGRAPHY|ECHOCARDIOGRAPHIES
ECHOENCEPHALOGRAPHY|ECHOENCEPHALOGRAPHIES
ECHOGRAPHY|ECHOGRAPHIES
ECHOLALIAS|ECHOLALIA
ECHOLOCATIONS|ECHOLOCATION
ECHOTOMOGRAPHY|ECHOTOMOGRAPHIES
ECHOVIRUSES|ECHOVIRUS
ECLAMPSIAS|ECLAMPSIA
ECLECTICISMS|ECLECTICISM
ECOLOGICAL|ECOLOGIC
ECOLOGY|ECOLOGIES
ECONOMIC|ECON
ECONOMICS|ECON
ECONOMY|ECONOMIES
ECTHYMAS|ECTHYMA
ECTODERMS|ECTODERM
ECTOGENESIS|ECTOGENESES
ECTOHORMONES|ECTOHORMONE
ECTOPIC|ECTOPIA
ECTROMELIAS|ECTROMELIA
ECTROPIONS|ECTROPION
ECZEMAS|ECZEMA
EDEMAS|EDEMA
EDEMATOUS|EDEMA
EDENTATAS|EDENTATA
EDETATES|EDETATE
EDROPONIUM|EDROPHONIUM
EDUC|EDUCATION
EDUCATIONAL|EDUCATION
EDUCATIONS|EDUCATION
EDWARDS|EDWARD
EEG|ECHOENCEPHALOGRAPHIES
EELS|EEL
EFFECT|EFF
EFFECTIVENESSES|EFFECTIVENESS
EFFECTS|EFF
EFFICIENCY|EFFICIENCIES
EFFORTS|EFFORT
EFFUSIONS|EFFUSION
EGGS|EGG
EGOISMS|EGOISM
EGOS|EGO
EICOSATRIENOIC|EICOSATRIENOATE
EIGENMANNIAS|EIGENMANNIA
EIGHT|8
EIGHTEEN|18
EIGTHY|80
EISENMENGERS|EISENMENGER
EJACULATIONS|EJACULATION
EJECTIONS|EJECTION
EKBOMS|EKBOM
EKONAZOLE|ECONAZOLE
ELAEOPHORIASIS|ELAEOPHORIASES
ELASTICAS|ELASTICA
ELASTICITY|ELASTICITIES
ELASTOMERS|ELASTOMER
ELBOWS|ELBOW
ELDERLY|AGED
ELDERS|ELDER
ELECTRICAL|ELECTRIC
ELECTRICITY|ELECTRICITIES
ELECTROACUPUNCTURES|ELECTROACUPUNCTURE
ELECTROANALGESIAS|ELECTROANALGESIA
ELECTROANESTHESIAS|ELECTROANESTHESIA
ELECTROCARDIOGRAPHY|ELECTROCARDIOGRAPHIES
ELECTROCAUTERY|ELECTROCAUTERIES
ELECTROCHEMISTRIES|ELECTROCHEM
ELECTROCHEMISTRY|ELECTROCHEM
ELECTROCOAGULATIONS|ELECTROCOAGULATION
ELECTROCOCHLEOGRAPHY|ELECTROCOCHLEOGRAPHIES
ELECTRODEPOSITIONS|ELECTRODEPOSITION
ELECTRODES|ELECTRODE
ELECTRODIAGNOSES|ELECTRODIAG
ELECTRODIAGNOSIS|ELECTRODIAG
ELECTROENCEPHALOGRAPHY|ELECTROENCEPHALOGRAPHIES
ELECTROFOCUSINGS|ELECTROFOCUSING
ELECTROGALVANISMS|ELECTROGALVANISM
ELECTROIMMUNOBLOTTING|ELECTROIMMUNOBLOT
ELECTROIMMUNOBLOTTINGS|ELECTROIMMUNOBLOT
ELECTROKYMOGRAPHY|ELECTROKYMOGRAPHIES
ELECTROLYSIS|ELECTROLYSES
ELECTROLYTES|ELECTROLYTE
ELECTROMAGNETICS|ELECTROMAGNETIC
ELECTROMYOGRAPHY|ELECTROMYOGRAPHIES
ELECTRONARCOSIS|ELECTRONARCOSES
ELECTRONICS|ELECTRONIC
ELECTRONS|ELECTRON
ELECTRONYSTAGMOGRAPHY|ELECTRONYSTAGMOGRAPHIES
ELECTROOCULOGRAPHY|ELECTROOCULOGRAPHIES
ELECTROPHORESIS|ELECTROPHORESES
ELECTROPHYSIOLOGIES|ELECTROPHYSIOL
ELECTROPHYSIOLOGY|ELECTROPHYSIOL
ELECTRORETINOGRAPHY|ELECTRORETINOGRAPHIES
ELECTROSHOCKS|ELECTROSHOCK
ELECTROSTIMULATIONS|ELECTROSTIMULATION
ELECTROSURGERIES|ELECTROSURG
ELECTROSURGERY|ELECTROSURG
ELECTROSYNERESIS|ELECTROSYNERESES
ELECTROTHERAPIES|ELECTROTHER
ELECTROTHERAPY|ELECTROTHER
ELECTROVERSIONS|ELECTROVERSION
ELEMENTS|ELEMENT
ELEPHANTIASIS|ELEPHANTIASES
ELEPHANTS|ELEPHANT
ELEVATION|ELEVATED
ELEVATORS|ELEVATOR
ELEVEN|11
ELLIPTICINES|ELLIPTICINE
ELLIPTOCYTOSES|ELIPTOCYTOSIS
ELLIPTOCYTOSIS|ELIPTOCYTOSIS
ELLMANS|ELLMAN
ELONGATIONS|ELONGATION
EMACIATIONS|EMACIATION
EMBALMINGS|EMBALMING
EMBLEMS|EMBLEM
EMBOLISM|EMBOLI
EMBOLISMS|EMBOLI
EMBOLIZATIONS|EMBOLIZATION
EMBOLUS|EMBOLI
EMBRYOLOGY|EMBRYOL
EMBRYONALS|EMBRYONAL
EMBRYOPATHY|EMBRYOPATHIES
EMBRYOS|EMBRYO
EMBRYOTOMY|EMBRYOTOMIES
EMERGENCY|EMERGENCIES
EMERGICENTERS|EMERGICENTER
EMERIMICINS|EMERIMICIN
EMEROGENES|EMEROGENE
EMETICS|EMETIC
EMG|ELECTROMYOGRAPHIES
EMIGRATIONS|EMIGRATION
EMINENCES|EMINENCE
EMISSION|EMISS
EMOTIONS|EMOTION
EMPATHY|EMPATHIES
EMPHYSEMAS|EMPHYSEMA
EMPLOYMENTS|EMPLOYMENT
EMPTYINGS|EMPTYING
EMPYEMAS|EMPYEMA
EMULSIONS|EMULSION
ENAMELS|ENAMEL
ENANTHATES|ENANTHATE
ENBUCRYLATE|ENBUCRILATE
ENCEPHALITIS|ENCEPHALITIDES
ENCEPHALOCELES|ENCEPHALOCELE
ENCEPHALOMALACIAS|ENCEPHALOMALACIA
ENCEPHALOMYELITIS|ENCEPHALOMYELITIDES
ENCEPHALOMYELOPATHY|ENCEPHALOMYELOPATHIES
ENCEPHALOPATHY|ENCEPHALOPATHIES
ENCHONDROMAS|ENCHONDROMA
ENCHONDROMATOSIS|ENCHONDROMATOSES
ENCHONDROSIS|ENCHONDROSES
ENCOPRESIS|ENCOPRESES
ENCORTONE|ENCORTON
ENCYCLOPEDIAS|ENCYCLOPEDIA
ENDARTERECTOMY|ENDARTERECTOMIES
ENDARTERITIS|ENDARTERITIDES
ENDINGS|ENDING
ENDOCARDIAL|ENDOCARD
ENDOCARDITIS|ENDOCARDITIDES
ENDOCARDIUM|ENDOCARD
ENDOCARDIUMS|ENDOCARD
ENDOCRINELIKE|ENDOCRINE
ENDOCYTOSIS|ENDOCYTOSES
ENDODEOXYRIBONUCLEASES|ENDODEOXYRIBONUCLEASE
ENDODERMS|ENDODERM
ENDODONTICS|ENDODONTIC
ENDOGLYCOSIDASES|ENDOGLYCOSIDASE
ENDOLYMPHS|ENDOLYMPH
ENDOMETRIAL|ENDOMETRIA
ENDOMETRIOSIS|ENDOMETRIOSES
ENDOMETRITIS|ENDOMETRITIDES
ENDOMETRIUM|ENDOMETRIA
ENDONUCLEASES|ENDONUCLEASE
ENDOPEPTIDASES|ENDOPEPTIDASE
ENDOPEROXIDES|ENDOPEROXIDE
ENDOPHTHALMITIS|ENDOPHTHALMITIDES
ENDOPROTEINASES|ENDOPROTEINASE
ENDORIBONUCLEASES|ENDORIBONUCLEASE
ENDORPHINS|ENDORPHIN
ENDOSCOPY|ENDOSCOPIES
ENDOSSEOUS|ENDOSS
ENDOTHELINS|ENDOTHELIN
ENDOTHELIUM|ENDOTHELIA
ENDOTHELIUMS|ENDOTHELIA
ENDOTOXIC|ENDOTOX
ENDOTOXINS|ENDOTOXIN
ENDOWMENTS|ENDOWMENT
ENDPLATES|ENDPLATE
ENDURANCES|ENDURANCE
ENEMAS|ENEMA
ENERGY|ENERGIES
ENGELMANNS|ENGELMANN
ENGINEERINGS|ENGINEERING
ENGINEERS|ENGINEER
ENGLAND|BRITAIN
ENGLISH|BRITAIN
ENGORGEMENTS|ENGORGEMENT
ENGRAVINGS|ENGRAVING
ENHANCEMENT|AUGMENTATION
ENHANCEMENTS|AUGMENTATION
ENHANCERS|ENHANCER
ENHANCING|AUGMENTING
ENKEPHALINS|ENKEPHALIN
ENKORTOLON|ENCORTON
ENLARGEMENTS|ENLARGEMENT
ENNIATINS|ENNIATIN
ENROLLMENTS|ENROLLMENT
ENTAMEBIASIS|AMEBIASES
ENTAMOEBIASIS|ENTAMOEBIASES
ENTERITIDES|GASTROENTERITIDES
ENTERITIS|GASTROENTERITIDES
ENTEROBIASIS|ENTEROBIASES
ENTEROCELES|ENTEROCELE
ENTEROCOLITIS|ENTEROCOLITIDES
ENTERODEZ|ENTERODES
ENTEROPATHY|ENTEROPATHIES
ENTEROSORPTIONS|ENTEROSORPTION
ENTEROSTOMY|ENTEROSTOMIES
ENTEROTOXEMIAS|ENTEROTOXEMIA
ENTEROTOXINS|ENTEROTOXIN
ENTEROVIRUS|ENTEROVIRAL
ENTEROVIRUSES|ENTEROVIRAL
ENTOMOLOGY|ENTOMOLOGIES
ENTROPIONS|ENTROPION
ENUCLEATIONS|ENUCLEATION
ENUMERATIONS|ENUMERATION
ENURESIS|ENURESES
ENVELOPES|ENVELOPE
ENVIRONMENTS|ENVIRONMENT
ENZYMES|ENZYME
ENZYMOLOGIC|ENZYMOL
EOSINE|EOSIN
EOSINOPHILIAS|EOSINOPHILIA
EOSINOPHILIC|EOSINOPHIL
EOSINOPHILS|EOSINOPHIL
EPENDYMAS|EPENDYMA
EPENDYMOMAS|EPENDYMOMA
EPERYTHROZOONOSIS|EPERYTHROZOONOSES
EPHEDRINE|EFFEDRIN
EPICHLOROHYDRIN|EPICHLORHYDRIN
EPICONDYLITIS|EPICONDYLITIDES
EPIDEMICS|EPIDEMIC
EPIDEMIOLOGIC|EPIDEMIOL
EPIDEMIOLOGICAL|EPIDEMIOL
EPIDEMIOLOGIES|EPIDEMIOL
EPIDEMIOLOGY|EPIDEMIOL
EPIDERMOPHYTOSIS|EPIDERMOPHYTOSES
EPIDIDYMIS|EPIDIDYMI
EPIDIDYMITIS|EPIDIDYMITIDES
EPIGLOTTIS|EPIGLOTTI
EPIGLOTTITIS|EPIGLOTTITIDES
EPILEPSY|EPILEPSIES
EPIMERASES|EPIMERASE
EPINEPHRINE|ADRENALINE
EPIPHYSES|EPIPHYSE
EPIPHYSIOLYSIS|EPIPHYSIOLYSES
EPIPHYSIS|EPIPHYSE
EPISCLERITIS|EPISCLERITIDES
EPISIOTOMY|EPISIOTOMIES
EPISOMES|EPISOME
EPISPADIAS|EPISPADIA
EPISTASIS|EPISTASES
EPITHELIOMAS|EPITHELIOMA
EPITHELIUMS|EPITHELIUM
EPONYMS|EPONYM
EPOPROSTENOL|EPOPROSTANOL
EPOXIDES|EPOXIDE
EQUALITY|EQUALITIES
EQUILIBRATIONS|EQUILIBRATION
EQUILIBRIUM|EQUILIBRIA
EQUILIBRIUMS|EQUILIBRIA
EQUINAS|EQUINA
EQUINOVARUS|EQUINOVARU
EQUIPMENTS|EQUIPMENT
EQUIVALENCE|BIOEQUIVALENCE
EQUIVALENCY|EQUIVALENCIES
ERABUTOXINS|ERABUTOXIN
ERECTIONS|ERECTION
ERGASTOPLASMS|ERGASTOPLASM
ERGOCALCIFEROLS|ERGOCALCIFEROL
ERGOKRYPTINE|ERGOCRYPTINE
ERGOLINES|ERGOLINE
ERGOMETRINE|ERGOMETRIN
ERGOTISMS|ERGOTISM
EROSIONS|EROSION
EROTIC|COITUS
ERROR|ERR
ERRORS|ERR
ERUCTATION|BELCHING
ERUCTATIONS|BELCHING
ERUPTIONS|ERUPTION
ERYSIPELAS|ERYSIPELA
ERYSIPELOIDS|ERYSIPELOID
ERYTHEMAS|ERYTHEMA
ERYTHEMATOSUS|ERYTHEMATOSIS
ERYTHEMATOUS|ERYTHEMA
ERYTHERMALGIAS|ERYTHERMALGIA
ERYTHRASMAS|ERYTHRASMA
ERYTHROBLASTOSIS|ERYTHROBLASTOSES
ERYTHROBLASTS|ERYTHROBLAST
ERYTHROCYTES|ERYTHROCYTE
ERYTHROCYTOSIS|ERYTHROCYTOSES
ERYTHRODERMAS|ERYTHRODERMA
ERYTHROLEUKEMIAS|ERYTHROLEUKEMIA
ERYTHROMELALGIAS|ERYTHROMELALGIA
ERYTHROPLASIAS|ERYTHROPLASIA
ERYTHROPOIESIS|ERYTHROPOIESES
ERYTHROSINE|ERYTHROSIN
ESCALATORS|ESCALATOR
ESCINA|ESCIN
ESIDRIX|ESIDREX
ESKIMOS|ESKIMO
ESOPHAGITIS|ESOPHAGITIDES
ESOPHAGOGASTRODUODENOSCOPY|ESOPHAGOGASTRODUODENOSCOPIES
ESOPHAGOPLASTY|ESOPHAGOPLASTIES
ESOPHAGOSCOPY|ESOPHAGOSCOPIES
ESOPHAGOSTOMY|ESOPHAGOSTOMIES
ESOPHAGU|ESOPHAGEAL
ESOPHAGUS|ESOPHAGEAL
ESOTROPIAS|ESOTROPIA
ESTEEMS|ESTEEM
ESTERASES|ESTERASE
ESTERIFICATIONS|ESTERIFICATION
ESTERS|ESTER
ESTHETICS|ESTHETIC
ESTIMATES|ESTIMATE
ESTIMATIONS|ESTIMATION
ESTIVATIONS|ESTIVATION
ESTRANES|ESTRANE
ESTRENE|ESTREN
ESTRENES|ESTREN
ESTROGENS|ESTROGEN
ETAMIPHYLLINE|ETAMIPHYLLIN
ETCHINGS|ETCHING
ETHACRYNIC|ETACRYNIC
ETHAMINAL|ETAMINAL
ETHAMSYLATE|ETAMSYLATE
ETHANEDIOLS|ETHANEDIOL
ETHANES|ETHANE
ETHANOL|ALCOHOL
ETHANOLAMINES|ETHANOLAMINE
ETHCHLORVINOL|ETHCHLOROVYNOL
ETHCHLORVYNOL|ETHCHLOROVYNOL
ETHERS|ETHER
ETHICAL|BIOETHICAL
ETHICS|ETHIC
ETHILONS|ETHILON
ETHIMIZOLE|ETHIMIZOL
ETHIODOLS|ETHIODOL
ETHMOIDAL|ETHMOID
ETHNOLOGY|ETHNOLOGIES
ETHNOMEDICINE|ETHNOMED
ETHNOMEDICINES|ETHNOMED
ETHNOPSYCHOLOGIES|ETHNOPSYCHOL
ETHNOPSYCHOLOGY|ETHNOPSYCHOL
ETHOSUXIMIDE|ETHOSUCCIMID
ETHOXZOLAMIDE|ETHOXYZOLAMIDE
ETHYLAMINES|ETHYLAMINE
ETHYLCAPROIC|ETHYLCAPROATE
ETHYLENEDIAMINES|ETHYLENEDIAMINE
ETHYLENEIMINES|ETHYLENEIMINE
ETHYLENES|ETHYLENE
ETHYLMERCURY|ETHYLMERCURIC
ETHYLMORPHINE|ETHOMORPHINE
ETHYMISOLE|ETHIMIZOL
ETHYMIZOL|ETHIMIZOL
ETHYNODIOL|ETHYNDIOL
ETHYNYL|ETHINYL
ETILEFRINE|ETILEFRIN
ETIMIZOL|ETHIMIZOL
ETOH|ALCOHOL
ETOMIDATE|ETHOMIDATE
ETONITAZIN|ETONITAZENE
ETONITAZINE|ETONITAZENE
ETORPHINE|ETHORPHINE
ETRAN|ETHRANE
EUDRAGITS|EUDRAGIT
EUFLAVINE|EUFLAVIN
EUGENICS|EUGENIC
EUGENOLS|EUGENOL
EUGLYCEMIC|EUGLYCAEMIC
EUMELANINS|EUMELANIN
EUNUCHISMS|EUNUCHISM
EUPATORIOPICRINE|EUPATORIOPICRIN
EUPHAUSIAS|EUPHAUSIA
EUPHORIAS|EUPHORIA
EUTAMIAS|EUTAMIA
EUTELEGENESIS|EUTELEGENESES
EUTHANASIAS|EUTHANASIA
EVALUATION|APPRAISAL
EVALUATIONS|APPRAISAL
EVASION|AVOIDANCE
EVENTRATIONS|EVENTRATION
EVENTS|EVENT
EVOLUTIONS|EVOLUTION
EWINGS|EWING
EXAMINATIONS|EXAMINATION
EXAMINERS|EXAMINER
EXANTHEMA|EXANTHEM
EXANTHEMAS|EXANTHEM
EXANTHEMATA|EXANTHEM
EXCAVATUMS|EXCAVATUM
EXCESSIVE|EXCESS
EXCHANGES|EXCHANGE
EXCISION|EXCIS
EXCISIONS|EXCIS
EXCITATIONS|EXCITATION
EXCITEMENT|AGITATION
EXCITEMENTS|AGITATION
EXCITOTOXINS|EXCITOTOXIN
EXECUTIONS|EXECUTION
EXENTERATIONS|EXENTERATION
EXERCISES|EXERCISE
EXERTIONS|EXERTION
EXFOLIATINS|EXFOLIATIN
EXFOLIATIONS|EXFOLIATION
EXFOLIATIVAS|EXFOLIATIVA
EXFOLIATIVE|EXFOLIATION
EXHAUSTIONS|EXHAUSTION
EXHAUSTS|EXHAUST
EXHIBITIONISMS|EXHIBITIONISM
EXHIBITS|EXHIBIT
EXOCYTOSIS|EXOCYTOSES
EXODEOXYRIBONUCLEASES|EXODEOXYRIBONUCLEASE
EXODEVIATIONS|EXODEVIATION
EXONS|EXON
EXONUCLEASES|EXONUCLEASE
EXORIBONUCLEASES|EXORIBONUCLEASE
EXORPHINS|EXORPHIN
EXOSTOSIS|EXOSTOSES
EXOTOXINS|EXOTOXIN
EXOTROPIAS|EXOTROPIA
EXPANDERS|EXPANDER
EXPANSIONS|EXPANSION
EXPECTANCY|EXPECTANCIES
EXPECTORANTS|EXPECTORANT
EXPEDITIONS|EXPEDITION
EXPENDITURES|EXPENDITURE
EXPERIENCES|EXPERIENCE
EXPERIMENTATIONS|EXPERIMENTATION
EXPERT|CONSULTANT
EXPLOSIONS|EXPLOSION
EXPOSURES|EXPOSURE
EXPRESSIONS|EXPRESSION
EXPULSIONS|EXPULSION
EXSTROPHY|EXSTROPHIES
EXTENDERS|EXTENDER
EXTENSION|EXTEN
EXTERNAL|EXOGENOUS
EXTERNAS|EXTERNA
EXTRACTIONS|EXTRACTION
EXTRACTS|EXTRACT
EXTRASYSTOLES|EXTRASYSTOLE
EXTRAVASATIONS|EXTRAVASATION
EXTREMITY|EXTREMITIES
EXTROPHIES|EXSTROPHIES
EXTROPHY|EXSTROPHIES
EXTROVERSION|EXTRAVERSION
EXTROVERSIONS|EXTRAVERSION
EXUDATES|EXUDATE
EYEBROWS|EYEBROW
EYELASHES|EYELASHE
EYELIDS|EYELID
EYES|EYE
FABRYS|FABRY
FACE|CRANIOFACIAL
FACES|CRANIOFACIAL
FACIAL|CRANIOFACIAL
FACILITATIONS|FACILITATION
FACILITIES|FACILITES
FACILITY|FACILITES
FACTOR|FACTEUR
FACTORS|FACTEUR
FACULTY|FACULTIES
FADS|FAD
FAILURES|FAILURE
FAINTINGS|FAINTING
FAIRS|FAIR
FAKE|FACTITIOUS
FALLACY|FALLACIES
FALLOTS|FALLOT
FALLOUTS|FALLOUT
FALLS|FALL
FAMIL|FAMILIES
FAMILIAL|HERED
FAMILY|HERED
FAMINES|FAMINE
FANCIERS|FANCIER
FANCONIS|FANCONI
FANGOTHERAPIES|FANGOTHER
FANGOTHERAPY|FANGOTHER
FANTASY|FANTASIES
FARCY|GLANDER
FARMER'S|FARMER
FARMERS|FARMER
FARMING|AGRICULTURAL
FASCIAS|FASCIA
FASCICULATIONS|FASCICULATION
FASCIITIS|FASCIITIDES
FASCIOLIASIS|FASCIOLIASES
FASCIOLOIDIASIS|FASCIOLOIDIASES
FASCIOLOPSIASIS|FASCIOLOPSIASES
FASCITIS|FASCITIDES
FASSO|FASO
FASTINGS|FASTING
FAT|OBESITIES
FATHERS|FATHER
FATIGUES|FATIGUE
FATS|OBESITIES
FATTY|OBESITIES
FAVISMS|FAVISM
FEARS|FEAR
FEATHERS|FEATHER
FECAL|FECE
FECES|FECE
FECUNDABILITY|FECUNDABILITIES
FECUNDITY|FECUNDITIES
FEEDBACKS|FEEDBACK
FEEDING|MEAL
FEEDINGS|MEAL
FEEDS|FEED
FEELINGS|FEELING
FEERS|FEER
FEES|FEE
FELDSHERS|FELDSHER
FELINE|CAT
FELLOWSHIPS|FELLOWSHIP
FELTYS|FELTY
FEMALES|FEMALE
FEMINIZATIONS|FEMINIZATION
FEMUR|FEMORAL
FEMURS|FEMORAL
FENCHLORPHOS|FENCHLORFOS
FENCLONINE|FENCLONIN
FENDILINE|FENDILIN
FENESTRATIONS|FENESTRATION
FENPROPIDINE|FENPROPIDIN
FERMENTATIONS|FERMENTATION
FERREDOXINS|FERREDOXIN
FERRETS|FERRET
FERRICYANIDES|FERRICYANIDE
FERROCERONE|FERROCERON
FERROCYANIDES|FERROCYANIDE
FERTILITIES|FERTIL
FERTILITY|FERTIL
FERTILIZATIONS|FERTILIZATION
FERTILIZERS|FERTILIZER
FESTIVALS|FESTIVAL
FETALIS|FETAL
FETOPROTEINS|FETOPROTEIN
FETOSCOPY|FETOSCOPIES
FETUINS|FETUIN
FETUS|FETAL
FETUSES|FETAL
FEVER|FEBRILE
FEVERS|FEBRILE
FIBERS|FIBER
FIBRILLATIONS|FIBRILLATION
FIBRILS|FIBRIL
FIBRINOGENS|FIBRINOGEN
FIBRINOLYSIS|FIBRINOLYSES
FIBRINOPEPTIDES|FIBRINOPEPTIDE
FIBROADENOSIS|FIBROADENOSES
FIBROBLASTS|FIBROBLAST
FIBROELASTOSIS|FIBROELASTOSES
FIBROIDS|FIBROID
FIBROMAS|FIBROMA
FIBROMATOSIS|FIBROMATOSES
FIBRONECTINS|FIBRONECTIN
FIBROPLASIAS|FIBROPLASIA
FIBROSARCOMAS|FIBROSARCOMA
FIBROSCOPIC|ENDOSCOPIC
FIBROSES|FIBROS
FIBROSIS|FIBROS
FIBROSITIS|FIBROSITIDES
FIBROUS|FIBROS
FIBULAS|FIBULA
FIELDS|FIELD
FIELDWORKERS|FIELDWORKER
FIFTEEN|15
FIFTY|50
FILAMENTS|FILAMENT
FILAMINS|FILAMIN
FILARIASIS|FILARIASES
FILES|FILE
FILINGS|FILING
FILLERS|FILLER
FILLINGS|FILLING
FILMS|FILM
FILTERABILITY|FILTERABILITIES
FILTERS|FILTER
FILTRATIONS|FILTRATION
FIMBRIECTOMY|FIMBRIECTOMIES
FINANCINGS|FINANCING
FINDINGS|FINDING
FINGERPRINTINGS|FINGERPRINTING
FINGERPRINTS|FINGERPRINT
FINGERS|FINGER
FINISHINGS|FINISHING
FIREARMS|FIREARM
FIRES|FIRE
FISHERY|FISHERIES
FISHES|FISH
FISHS|FISH
FISSIONS|FISSION
FISSURED|FISSURE
FISSURES|FISSURE
FISTULAS|FISTULA
FITNESSES|FITNESS
FIVE|5
FIXATIONS|FIXATION
FIXATIVES|FIXATIVE
FIXATORS|FIXATOR
FIXED|FIXATION
FLACCIDITY|FLACCIDITIES
FLAGELLAS|FLAGELLA
FLAGELLUMS|FLAGELLUM
FLAPS|FLAP
FLATFISHES|FLATFISHE
FLATUS|FLATULENCE
FLATWORMS|FLATWORM
FLAVINS|FLAVIN
FLAVIVIRUSES|FLAVIVIRUS
FLAVOMYCINS|FLAVOMYCIN
FLAVONES|FLAVONE
FLAVONOLS|FLAVONOL
FLAVOPHOSPHOLIPOLS|FLAVOPHOSPHOLIPOL
FLAVOPROTEINS|FLAVOPROTEIN
FLEAS|FLEA
FLIGHTS|FLIGHT
FLOATERS|
FLOATER
FLOCCULATIONS|FLOCCULATION
FLOCTAFENINE|FLOCTAFENIN
FLOODINGS|FLOODING
FLOODS|FLOOD
FLOORCOVERINGS|FLOORCOVERING
FLOORS|FLOOR
FLOUNDERS|FLOUNDER
FLOURS|FLOUR
FLOWCHARTS|FLOWCHART
FLOWMETERS|FLOWMETER
FLOWS|FLOW
FLUCTUANT|FLUCTUANCE
FLUFYLLINE|FLUFYLLIN
FLUIDITY|FLUIDITIES
FLUIDS|FLUID
FLUKES|FLUKE
FLUNARIZINE|FLUNARIZIN
FLUORENE|FLUOREN
FLUORENES|FLUOREN
FLUORESCEINS|FLUORESCEIN
FLUORESCENCES|FLUORESCENCE
FLUORIDATIONS|FLUORIDATION
FLUORIDES|FLUORIDE
FLUOROACETATES|FLUOROACETATE
FLUOROBENZOIC|FLUOROBENZOATE
FLUOROCARBONS|FLUOROCARBON
FLUOROGESTONE|FLUGESTONE
FLUOROGLUTAMIC|FLUOROGLUTAMATE
FLUOROIMMUNOASSAYS|FLUOROIMMUNOASSAY
FLUOROMETRY|FLUOROMETRIES
FLUOROSCOPY|FLUOROSCOPIES
FLUOROSES|FLUOROSE
FLUOROSIS|FLUOROSE
FLUORURACIL|FLUOROURACIL
FLUOXETINE|FLUOXETIN
FLUOXYMESTERONE|FLUOXIMESTERON
FLUPENTIXOL|FLUPENTHIXOL
FLUPHENAZINE|FLUFENAZIN
FLUPROPHYLLINE|FLUPROPHYLLIN
FLURBIPROFEN|FLUBIPROFEN
FLURIDRAZEPAM|FLUNITRAZEPAM
FLURIPROBEN|FLUBIPROFEN
FLUROGESTONE|FLUGESTONE
FLUROTHYL|FLUOROTHYL
FLUSHINGS|FLUSHING
FLUTONIDINE|FLUTONIDIN
FLUTTERS|FLUTTER
FLY|FLIES
FOAMS|FOAM
FOCUSINGS|FOCUSING
FOLATES|FOLATE
FOLDS|FOLD
FOLIC|FOLATE
FOLKLORES|FOLKLORE
FOLLICLE|FOLLIC
FOLLICLES|FOLLIC
FOLLICULAR|FOLLIC
FOLLICULITIS|FOLLICULITIDES
FOLLOWUP|FOLLOW
FOOD|DIET
FOODS|DIET
FOOT|FEET
FOOTBALLS|FOOTBALL
FOOTS|FEET
FORAMENA|FORAMEN
FORAMENS|FORAMEN
FORCEPS|FORCEP
FORCES|FORCE
FOREARMS|FOREARM
FORECASTS|FORECAST
FOREHEADS|FOREHEAD
FOREIGNERS|FOREIGNER
FORELIMBS|FORELIMB
FORGETFUL|AMNESIC
FORMAMIDES|FORMAMIDE
FORMATES|FORMATE
FORMATIONS|FORMATION
FORMAZANS|FORMAZAN
FORMICATIONS|FORMICATION
FORMOCRESOLS|FORMOCRESOL
FORMS|FORM
FORMULARY|FORMULARIES
FORMULAS|FORMULA
FORMULATIONS|FORMULATION
FORMYCINS|FORMYCIN
FORMYLMETHIONYL|FORMYLMETHIONINE
FORMYLTETRAHYDROFOLATES|FORMYLTETRAHYDROFOLATE
FORTIMICINS|FORTIMICIN
FORTY|40
FOSSAS|FOSSA
FOSSILS|FOSSIL
FOUNDATIONS|FOUNDATION
FOUR|4
FOURTEEN|14
FOWLS|FOWL
FOXES|FOX
FRACTIONATIONS|FRACTIONATION
FRACTIONS|FRACTION
FRACTURES|FRACTURE
FRACTURINGS|FRACTURING
FRAGILE|BRITTLE
FRAGILITY|FRAGILITIES
FRAGMENTOGRAPHY|FRAGMENTOGRAPHIES
FRAGMENTS|FRAGMENT
FRAMES|FRAME
FRAMESHIFTS|FRAMESHIFT
FRANKLINS|FRANKLIN
FRAUDS|FRAUD
FRECKLES|FRECKLE
FREEDOMS|FREEDOM
FREEZINGS|FREEZING
FREIDREICHS|FREIDREICH
FREIDRIECH|FREIDREICH
FREIDRIECHS|FREIDREICH
FRENUMS|FRENUM
FREONS|FREON
FREQUENCY|FREQUENCIES
FREQUENT|FREQUENCIES
FREUNDS|FREUND
FREYS|FREY
FRIEDERICHSEN|FRIDERICHSEN
FRIEDREICH|FREIDREICH
FRIEDREICHS|FREIDREICH
FRIEDRIECH|FREIDREICH
FRIEDRIECHS|FREIDREICH
FRIENDS|FRIEND
FRIGIDITY|FRIGIDITIES
FROEHLICHS|FROEHLICH
FROGS|FROG
FROMMELS|FROMMEL
FROSTBITES|FROSTBITE
FRUCTOKINASES|FRUCTOKINASE
FRUCTOSEDIPHOSPHATES|FRUCTOSEDIPHOSPHATE
FRUITS|FRUIT
FRUSTRATIONS|FRUSTRATION
FUCHS|FUCH
FUCHSINS|FUCHSIN
FUCOSIDOSIS|FUCOSIDOSES
FUCOSYLTRANSFERASES|FUCOSYLTRANSFERASE
FUELS|FUEL
FUGUES|FUGUE
FUMARATES|FUMARATE
FUMIGANTS|FUMIGANT
FUMIGATIONS|FUMIGATION
FUNCTIONS|FUNCTION
FUNDAZOL|FUNDASOL
FUNDINGS|FUNDING
FUNDS|FUND
FUNGI|FUNGAL
FUNGICIDES|FUNGICIDE
FUNGOIDES|FUNGOIDE
FUNGUS|FUNGAL
FURACILLIN|FURACILIN
FURALTADONE|FURALTADON
FURANS|FURAN
FURANTRAL|FURANTHRIL
FURAZOLIDONE|FURAZOLIDINE
FURNISHINGS|FURNISHING
FURNITURES|FURNITURE
FURROWED|FURROW
FURUNCULOSIS|FURUNCULOSES
FUSAFUNGINE|FUSAFUNGIN
FUSARITOXIN|FUSARIOTOXIN
FUSIONS|FUSION
GABACULINE|GABACULIN
GAINS|GAIN
GAIRDNERUS|GAIRDNERI
GAITS|GAIT
GALACTANS|GALACTAN
GALACTOCEREBROSIDES|GALACTOCEREBROSIDE
GALACTOLIPIDS|GALACTOLIPID
GALACTOPROTEINS|GALACTOPROTEIN
GALACTORRHEAS|GALACTORRHEA
GALACTOSEMIAS|GALACTOSEMIA
GALACTOSEPHOSPHATES|GALACTOSEPHOSPHATE
GALACTOSIDASES|GALACTOSIDASE
GALACTOSIDES|GALACTOSIDE
GALACTOSYLCERAMIDES|GALACTOSYLCERAMIDE
GALACTOSYLTRANSFERASES|GALACTOSYLTRANSFERASE
GALAGOS|GALAGO
GALLBLADDERS|GALLBLADDER
GALLSTONES|CHOLELITHIASES
GALLUS|GALLI
GALVANISMS|GALVANISM
GAMASOIDIASIS|GAMASOIDIASES
GAMBLINGS|GAMBLING
GAMBUSIAS|GAMBUSIA
GAMES|GAME
GAMETOGENESIS|GAMETOGENESES
GAMMAPATHY|GAMMAPATHIES
GAMMOPATHIES|GAMMAPATHIES
GAMMOPATHY|GAMMAPATHIES
GANCYCLOVIR|GANCICLOVIR
GANGLIAS|GANGLIA
GANGLION|GANGLIA
GANGLIONECTOMY|GANGLIONECTOMIES
GANGLIONEUROMAS|GANGLIONEUROMA
GANGLIONS|GANGLIA
GANGLIOSIDES|GANGLIOSIDE
GANGLIOSIDOSIS|GANGLIOSIDOSES
GANGRENE|NECROSES
GANGRENES|NECROSES
GANGRENOUS|NECROSES
GAPS|GAP
GARBAGES|GARBAGE
GARGOYLISMS|GARGOYLISM
GARLICS|GARLIC
GARTNERS|GARTNER
GASES|GAS
GASOLINES|GASOLINE
GASSERS|GASSER
GASTRECTOMY|GASTRECTOMIES
GASTRIC|GASTR
GASTRINOMAS|GASTRINOMA
GASTRINS|GASTRIN
GASTRITIS|GASTRITIDES
GASTROCOELES|GASTROCOELE
GASTRODINE|GASTRODIN
GASTROENTERITIS|GASTROENTERITIDES
GASTROENTEROSTOMY|GASTROENTEROSTOMIES
GASTROGRAPHIN|GASTROGRAFIN
GASTROPLASTY|GASTROPLASTIES
GASTROSCOPY|GASTROSCOPIES
GASTROSTOMY|GASTROSTOMIES
GASTROZEPIN|GASTROTSEPIN
GASTRULAS|GASTRULA
GATEKEEPERS|GATEKEEPER
GATINGS|GATING
GAUCHERS|GAUCHER
GEESES|GEESE
GEHRIGS|GEHRIG
GEL|JELLIES
GELADAS|GELADA
GELATINOSAS|GELATINOSA
GELS|JELLIES
GELSEMINE|GELSEMIN
GENEALOGY|GENEALOGIES
GENEOLOGIES|GENEALOGIES
GENEOLOGY|GENEALOGIES
GENERALIZATIONS|GENERALIZATION
GENERATORS|GENERATOR
GENES|GENE
GENET|HERED
GENETIC|HERED
GENETICS|HERED
GENITALIA|GENITAL
GENITALIAS|GENITAL
GENITALIS|GENITAL
GENITALS|GENITAL
GENOCIDES|GENOCIDE
GENOMES|GENOME
GENOMIC|GENOME
GENOTYPES|GENOTYPE
GENTAMICINS|GENTAMICIN
GENTAMYCIN|GENTAMICIN
GENTAMYCINS|GENTAMICIN
GENTISATES|GENTISATE
GEOLOGY|GEOLOGIES
GEOTRICHOSIS|GEOTRICHOSES
GEPEFRINE|GEPEFRIN
GEPHARNATE|GEFARNATE
GERBILS|GERBIL
GERIATRICS|GERIATRIC
GERM|VIRAL
GERMANY|GERMAN
GERMINOBLASTOMAS|GERMINOBLASTOMA
GERMS|VIRAL
GERONTOLOGY|GERONTOLOGIES
GERSTMANNS|GERSTMANN
GESTATIONIS|GESTATIONI
GESTODENE|GESTODEN
GESTOSIS|GESTOSES
GESTURES|GESTURE
GHETTOS|GHETTO
GHOSTS|GHOST
GI|GASTROINTESTINAL
GIARDIASIS|GIARDIASES
GIARDINS|GIARDIN
GIBBONS|GIBBON
GIERKES|GIERKE
GIFTS|GIFT
GIGANTISMS|GIGANTISM
GILBERTS|GILBERT
GILLS|GILL
GINGIVA|GUM
GINGIVAE|GUM
GINGIVAL|GUM
GINGIVAS|GUM
GINGIVECTOMY|GINGIVECTOMIES
GINGIVITIS|GINGIVITIDES
GINGIVOPLASTY|GINGIVOPLASTIES
GINGIVOSIS|GINGIVOSES
GINGIVOSTOMATITIS|GINGIVOSTOMATITIDES
GINSENOSIDES|GINSENOSIDE
GIPSY|GIPSIES
GIRL|FEMALE
GIZZARDS|GIZZARD
GLAFENINE|GLAFENIN
GLANDERS|GLANDER
GLANDS|GLAND
GLAPHENINE|GLAFENIN
GLASSE|EYEGLASSE
GLASSES|GLASS
GLAUCOMAS|GLAUCOMA
GLICENTINE|GLICENTIN
GLIKLAZID|GLICLAZIDE
GLIOMAS|GLIOMA
GLIOSIS|GLIOSES
GLIOTOXINS|GLIOTOXIN
GLISOXEPIDE|GLISOXEPID
GLOBOSIDES|GLOBOSIDE
GLOBULINS|GLOBULIN
GLOMANGIOMAS|GLOMANGIOMA
GLOMERULONEPHRITIS|GLOMERULONEPHRITIDES
GLOMERULOPATHY|GLOMERULOPATHIES
GLOMERULOSCLEROSIS|GLOMERULOSCLEROSES
GLOSSALGIAS|GLOSSALGIA
GLOSSECTOMY|GLOSSECTOMIES
GLOSSITIS|GLOSSITIDES
GLOSSODYNIAS|GLOSSODYNIA
GLOTTIS|GLOTTI
GLOVES|GLOVE
GLUCAGONOMAS|GLUCAGONOMA
GLUCANS|GLUCAN
GLUCOCEREBROSIDES|GLUCOCEREBROSIDE
GLUCOCORTICOIDS|GLUCOCORTICOID
GLUCOMETACINE|GLUCOMETACIN
GLUCONATES|GLUCONATE
GLUCONEOGENESIS|GLUCONEOGENESES
GLUCOPROTEINS|GLUCOPROTEIN
GLUCOSEPHOSPHATES|GLUCOSEPHOSPHATE
GLUCOSIDASES|GLUCOSIDASE
GLUCOSIDES|GLUCOSIDE
GLUCOSIDURONATES|GLUCOSIDURONATE
GLUCOSYLCERAMIDES|GLUCOSYLCERAMIDE
GLUCOSYLTRANSFERASES|GLUCOSYLTRANSFERASE
GLUCURONATES|GLUCURONATE
GLUCURONIC|GLUCURONATE
GLUCURONIDES|GLUCURONIDE
GLUCURONO|GLUCURONATE
GLUE|ADHESIVE
GLUES|ADHESIVE
GLUTAMATES|GLUTAMATE
GLUTAMIC|GLUTAMATE
GLUTAMINYL|GLUTAMINE
GLUTAMYL|GLUTAMATE
GLUTAMYLAMINOMETHYLPHOSPHONIC|GLUTAMYLAMINOMETHYLPHOSPHONATE
GLUTARATES|GLUTARATE
GLUTAURINE|GLUTAURIN
GLUTELINS|GLUTELIN
GLYCANS|GLYCAN
GLYCERIDES|GLYCERIDE
GLYCERINE|GLYCERIN
GLYCEROLPHOSPHATES|GLYCEROLPHOSPHATE
GLYCEROPHOSPHATES|GLYCEROPHOSPHATE
GLYCEROPHOSPHOLIPIDS|GLYCEROPHOSPHOLIPID
GLYCINATE|GLYCINAMIDE
GLYCINE|GLYCINAMIDE
GLYCLAZIDE|GLICLAZIDE
GLYCOCONJUGATES|GLYCOCONJUGATE
GLYCOGENOSIS|GLYCOGENOSES
GLYCOHYDROLASES|GLYCOHYDROLASE
GLYCOLATES|GLYCOLATE
GLYCOLIC|GLYCOLATE
GLYCOLIPIDS|GLYCOLIPID
GLYCOLLATE|GLYCOLATE
GLYCOLS|GLYCOL
GLYCOLYSIS|GLYCOLYSES
GLYCOPEPTIDES|GLYCOPEPTIDE
GLYCOPROTEINS|GLYCOPROTEIN
GLYCOSAMINOGLYCANS|GLYCOSAMINOGLYCAN
GLYCOSIDASES|
GLYCOSIDASE
GLYCOSIDES|GLYCOSIDE
GLYCOSPHINGOLIPIDS|GLYCOSPHINGOLIPID
GLYCOSURIAS|GLYCOSURIA
GLYCOSYLATIONS|GLYCOSYLATION
GLYCYL|GLYCINAMIDE
GLYCYRAM|GLYCIRAM
GLYCYRRHIZIA|GLYCYRRHIZA
GLYDIAZINAMIDE|GLIDIAZINAMIDE
GLYOXYLATES|GLYOXYLATE
GNOTOBIOTICS|GNOTOBIOTIC
GOALS|GOAL
GOATS|GOAT
GOGGLES|GOGGLE
GOITERS|GOITER
GOLDFISHS|GOLDFISH
GOLDS|GOLD
GOLFS|GOLF
GONADOTROPINS|GONADOTROPIN
GONADS|GONAD
GONDERIASIS|GONDERIASES
GONIOSCOPY|GONIOSCOPIES
GONIOTOMY|GONIOTOMIES
GONORRHEAS|GONORRHEA
GONOSOMES|GONOSOME
GONYAUTOXINS|GONYAUTOXIN
GOODPASTURES|GOODPASTURE
GOOSE|GEESE
GORILLAS|GORILLA
GOSSYPIUMS|GOSSYPIUM
GOSTATINE|GOSTATIN
GOUTY|GOUT
GOVERNMENTS|GOVERNMENT
GOVT|GOV
GRADENIGOS|GRADENIGO
GRADUATE|GRAD
GRADUATES|GRAD
GRAFFIS|GRAFFI
GRAFT|TRANSPL
GRAFTING|TRANSPL
GRAFTINGS|TRANSPL
GRAFTS|TRANSPL
GRAINS|GRAIN
GRAMICIDINS|GRAMICIDIN
GRAMMAPHOS|GAMMAPHOS
GRANINS|GRANIN
GRANTS|GRANT
GRANULATIONS|GRANULATION
GRANULES|GRANULE
GRANULOCYTES|GRANULOCYTE
GRANULOCYTOPENIAS|GRANULOCYTOPENIA
GRANULOMA|GRANULOM
GRANULOMAS|GRANULOM
GRANULOMATOSIS|GRANULOMATOSES
GRANULOMATOUS|GRANULOM
GRAPES|GRAPE
GRAPHICS|GRAPHIC
GRASSES|GRASS
GRASSHOPPERS|GRASSHOPPER
GRAVES|GRAVE
GRAVIDARUMS|GRAVIDARUM
GRAVIGARDS|GRAVIGARD
GRAVIS|GRAVI
GRAVITATIONS|GRAVITATION
GRAVITY|GRAVITIES
GRAY|GRAIES
GRAYLINGS|GRAYLING
GREASE|OBESITIES
GREASY|OBESITIES
GRIEVANCES|GRIEVANCE
GROENOUWS|GROENOUW
GROINS|GROIN
GROOMINGS|GROOMING
GROOVES|GROOVE
GROSSLY|GROSS
GROUNDNUTS|GROUNDNUT
GROUPS|GROUP
GROWTHS|GROWTH
GUAIACUM|GUAIAC
GUAIPHENESIN|GUAIFENESIN
GUAIPHENEZINE|GUAIFENESIN
GUANACOS|GUANACO
GUANIDINES|GUANIDINE
GUANIDINOBUTYRIC|GUANIDINOBUTYRATE
GUARDIANS|GUARDIAN
GUGLIELMOS|GUGLIELMO
GUIDANCES|GUIDANCE
GUIDELINE|RULE
GUIDELINES|RULE
GUILTS|GUILT
GUMS|GUM
GUN|FIREARM
GUNS|FIREARM
GUPPY|GUPPIES
GUT|ABDOMEN
GUTIMINE|GUTIMIN
GUTS|ABDOMEN
GYMNASTICS|GYMNASTIC
GYMNOTIDS|GYMNOTID
GYNANDROBLASTOMAS|GYNANDROBLASTOMA
GYNECOLOGICAL|GYNECOLOGIC
GYNECOLOGY|GYNECOL
GYNECOMASTIAS|GYNECOMASTIA
GYPSIES|GIPSIES
GYPSY|GIPSIES
GYRECTOMY|GYRECTOMIES
HABILITATIONS|HABILITATION
HABITS|HABIT
HABITUATIONS|HABITUATION
HABRONEMIASIS|HABRONEMIASES
HAEMATOBIAS|HAEMATOBIA
HAEMATOBIUM|HAEMATOBIA
HAEMATOBIUMS|HAEMATOBIA
HAEMATOXYLUM|HAEMATOXYLIN
HAEMOBARTONELLOSIS|HAEMOBARTONELLOSES
HAEMONCHIASIS|HAEMONCHIASES
HAEMOPHILUS|HAEMOPHILU
HAGFISHS|HAGFISH
HAIR|BRISTLE
HAIRS|BRISTLE
HALITOSIS|HALITOSES
HALLERMANNS|HALLERMANN
HALLUCINATIONS|HALLUCINATION
HALLUCINOGENICS|HALLUCINOGEN
HALLUCINOGENS|HALLUCINOGEN
HALLUCINOSIS|HALLUCINOSES
HALLUXS|HALLUX
HAMADRYAS|HAMADRYA
HAMARTOMAS|HAMARTOMA
HAMSTERS|HAMSTER
HANDEDNESSES|HANDEDNESS
HANDGUN|FIREARM
HANDICAPPEDS|HANDICAPPED
HANDLINGS|HANDLING
HANDS|HAND
HANDWASHINGS|HANDWASHING
HANDWRITINGS|HANDWRITING
HANSENS|HANSEN
HAPALES|HAPALE
HAPLOIDY|HAPLOIDIES
HAPLOTYPES|HAPLOTYPE
HAPPINESSES|HAPPINESS
HAPTENS|HAPTEN
HAPTOGLOBINS|HAPTOGLOBIN
HARDNESS|HARD
HARDNESSES|HARD
HARELIPS|HARELIP
HARES|HARE
HARMANE|HARMAN
HARRINGTONINES|HARRINGTONINE
HASHIMOTOS|HASHIMOTO
HASHISH|MARIHUANA
HATES|HATE
HAZARDS|HAZARD
HCO3|BICARBONATE
HEAD|CRANIAL
HEADACHE|CEPHALALGIA
HEADACHES|CEPHALALGIA
HEADGEARS|HEADGEAR
HEADINGS|HEADING
HEADS|CRANIAL
HEALINGS|HEALING
HEALTHS|HEALTH
HEARING|HEAR
HEARINGS|HEAR
HEART|CARDIAC
HEARTS|CARDIAC
HEATINGS|HEATING
HEAVE|PULSE
HEDGEHOGS|HEDGEHOG
HEDONISMS|HEDONISM
HEEL|CALCANEUS
HEELS|CALCANEUS
HEIGHT|ALTITUDE
HEIGHTS|ALTITUDE
HELICASES|HELICASE
HELICOPTERS|HELICOPTER
HELIOTHERAPIES|HELIOTHER
HELIOTHERAPY|HELIOTHER
HELMETS|HELMET
HELMINTHIASIS|HELMINTHIASES
HELMINTHS|HELMINTH
HELPLESSNESSES|HELPLESSNESS
HEMADSORPTIONS|HEMADSORPTION
HEMAGGLUTINATIONS|HEMAGGLUTINATION
HEMAGGLUTININS|HEMAGGLUTININ
HEMANGIOENDOTHELIOMAS|HEMANGIOENDOTHELIOMA
HEMANGIOMAS|HEMANGIOMA
HEMANGIOPERICYTOMAS|HEMANGIOPERICYTOMA
HEMANGIOSARCOMAS|HEMANGIOSARCOMA
HEMARTHROSIS|HEMARTHROSES
HEMATEMESIS|HEMATEMESES
HEMATINICS|HEMATINIC
HEMATOCELES|HEMATOCELE
HEMATOCOLPOS|HEMATOCOLPO
HEMATOCRITS|HEMATOCRIT
HEMATOLOGIC|HEMATOL
HEMATOLOGICAL|HEMATOL
HEMATOMAS|HEMATOMA
HEMATOMETRAS|HEMATOMETRA
HEMATOPOIESIS|HEMATOPOIESES
HEMATOPORPHYRINS|HEMATOPORPHYRIN
HEMATOXILINE|HAEMATOXYLIN
HEMATOXYLIN|HAEMATOXYLIN
HEMATURIAS|HEMATURIA
HEME|HAEM
HEMEPROTEINS|HEMEPROTEIN
HEMERALOPIAS|HEMERALOPIA
HEMIANOPSIA|HEMIANOPIA
HEMIANOPSIAS|HEMIANOPIA
HEMIATROPHY|HEMIATROPHIES
HEMIPARESIS|HEMIPARESES
HEMIPELVECTOMY|HEMIPELVECTOMIES
HEMIPLEGIAS|HEMIPLEGIA
HEMIPTERAS|HEMIPTERA
HEMOBILIAS|HEMOBILIA
HEMOCCULT|GUAIAC
HEMOCHROMATOSIS|HEMOCHROMATOSES
HEMOCYTES|HEMOCYTE
HEMODIALYSIS|HEMODIALYSES
HEMODIALYZATES|HEMODIALYSATES
HEMODILUTIONS|HEMODILUTION
HEMODYNAMICS|HEMODYNAMIC
HEMOFILTRATIONS|HEMOFILTRATION
HEMOGLOBINOMETRY|HEMOGLOBINOMETRIES
HEMOGLOBINOPATHY|HEMOGLOBINOPATHIES
HEMOGLOBINS|HEMOGLOBIN
HEMOGLOBINURIAS|HEMOGLOBINURIA
HEMOGLOBINURIC|HEMOGLOBINURIA
HEMOHISTIOBLAST|HEMATOHISTIOBLAST
HEMOLYMPHS|HEMOLYMPH
HEMOLYSIN|HEMALYSINS
HEMOLYSINS|HEMALYSINS
HEMOLYSIS|HEMOLYSES
HEMOLYTIC|HEMOL
HEMOPERFUSIONS|HEMOPERFUSION
HEMOPERICARDIUMS|HEMOPERICARDIUM
HEMOPERITONEUMS|HEMOPERITONEUM
HEMOPHIL|HEMOFIL
HEMOPHILIAS|HEMOPHILIA
HEMOPHILU|HAEMOPHILU
HEMOPHILUS|HAEMOPHILU
HEMOPNEUMOTHORAXS|HEMOPNEUMOTHORAX
HEMOPTYSIS|HEMOPTYSES
HEMORR|HEMOR
HEMORRHAGE|HEMOR
HEMORRHAGES|HEMOR
HEMORRHAGIC|HEMOR
HEMORRHOIDS|HEMORRHOID
HEMOSIDEROSIS|HEMOSIDEROSES
HEMOSORBENTS|HEMOSORBENT
HEMOSORPTIONS|HEMOSORPTION
HEMOSTASIS|HEMOSTASES
HEMOSTATICS|HEMOSTATIC
HEMOTHERAPIES|HEMOTHER
HEMOTHERAPY|HEMOTHER
HEMOTHORAXS|HEMOTHORAX
HEMOTOXINS|HEMATOXINS
HEMPAS|HEMPA
HEPADNAVIRUS|HEPADNAVIRIDAE
HEPADNAVIRUSES|HEPADNAVIRIDAE
HEPATECTOMY|HEPATECTOMIES
HEPATIS|HEPATI
HEPATITIS|HEPATITIDES
HEPATOMAS|HEPATOMA
HEPATOMEGALY|HEPATOMEGALIES
HEPTANE|HEPTAN
HEPTANES|HEPTAN
HEPTANOATES|HEPTANOATE
HEPTOSES|HEPTOSE
HERBALISMS|HERBALISM
HERBICIDES|HERBICIDE
HEREDIT|HERED
HEREDITARY|HERED
HERLITZS|HERLITZ
HERMAPHRODITISMS|HERMAPHRODITISM
HERNIAS|HERNIA
HERPANGINAS|HERPANGINA
HERPESVIRUSES|HERPESVIRUS
HERS|HER
HESPEROMYINES|HESPEROMYINAE
HETEROCHROMATINS|HETEROCHROMATIN
HETEROCHROMIC|HETEROCHROMIA
HETERODUPLEXES|HETERODUPLEX
HETEROGENEITY|HETEROGENEITIES
HETEROGENETIC|HETEROGENET
HETEROGRAFTS|HETEROGRAFT
HETEROLOGOUS|HETEROL
HETEROPHILE|HETEROPHIL
HETEROPNEUSTES|HETEROPNEUSTE
HETEROZYGOTES|HETEROZYGOTE
HEXADECYNOIC|HEXADECYNOATE
HEXAMETHYLENEIMINES|HEXAMETHYLENEIMINE
HEXANES|HEXANE
HEXANOATES|HEXANOATE
HEXANOLS|HEXANOL
HEXANONES|HEXANONE
HEXOSAMINES|HEXOSAMINE
HEXOSAMINIDASES|HEXOSAMINIDASE
HEXOSAMINOGLYCANS|HEXOSAMINOGLYCAN
HEXOSEPHOSPHATES|HEXOSEPHOSPHATE
HEXOSES|HEXOSE
HEXURONIC|HEXOURONIC
HHNCS|HHNC
HIATUS|HIATAL
HIBERNATIONS|HIBERNATION
HICCUPS|HICCUP
HIDRADENOMAS|HIDRADENOMA
HIERARCHY|HIERARCHIES
HIGHNESS|HIGH
HINDLIMBS|HINDLIMB
HIPPOTRAGINES|HIPPOTRAGINE
HIPPURATES|HIPPURATE
HIPS|HIP
HIRSCHSPRUNGS|HIRSCHSPRUNG
HIRSUTE|HAIRY
HIRSUTISMS|HIRSUTISM
HIRUDINEAS|HIRUDINEA
HISTIDYL|HISTIDINE
HISTIOCYTES|HISTIOCYTE
HISTIOCYTOMAS|HISTIOCYTOMA
HISTIOCYTOSIS|HISTIOCYTOSES
HISTOACRYL|HISTACRYL
HISTOCHEMICAL|HISTOCHEM
HISTOCOMPATIBILITY|HISTOCOMPATIBILITIES
HISTOCYTOCHEMISTRY|HISTOCYTOCHEM
HISTOLOGIC|HISTOL
HISTOLOGICAL|HISTOL
HISTOLOGIES|HISTOL
HISTOLOGY|HISTOL
HISTOMONIASIS|HISTOMONIASES
HISTONES|HISTONE
HISTOPLASMOSIS|HISTOPLASMOSES
HISTORIES|HIST
HISTORIOGRAPHY|HISTORIOGRAPHIES
HISTORY|HIST
HISTRIONICOTOXINS|HISTRIONICOTOXIN
HIVES|HIVE
HMSNS|HMSN
HOARSENESSES|HOARSENESS
HOBBY|HOBBIES
HOCKEYS|HOCKEY
HOCKS|HOCK
HODGKINS|HODGKIN
HOFFMANN|HOFFMAN
HOLDINGS|HOLDING
HOLES|HOLE
HOLIDAYS|HOLIDAY
HOLMES|HOLM
HOLOCAUST|GENOCIDE
HOLOPROSENCEPHALY|
HOLOPROSENCEPHALIES
HOLOTHUROIDEAS|HOLOTHUROIDEA
HOME|DOMESTIC
HOMEOSTASIS|HOMEOSTASES
HOMES|DOMESTIC
HOMESICKNESSES|HOMESICKNESS
HOMICIDES|HOMICIDE
HOMINIDAE|HOMINID
HOMINIDS|HOMINID
HOMINIS|HOMINI
HOMOCYSTINURIAS|HOMOCYSTINURIA
HOMOGRAFTS|HOMOGRAFT
HOMOLOGIES|HOMOL
HOMOLOGOUS|HOMOL
HOMOLOGY|HOMOL
HOMOPOLYMERS|HOMOPOLYMER
HOMOSEXUALITY|HOMOSEXUALITIES
HOMOSEXUALS|HOMOSEXUAL
HOMOZYGOTES|HOMOZYGOTE
HONEY|HONEIES
HOOKS|HOOK
HOOKWORMS|HOOKWORM
HOOVES|HOOF
HORDEUMS|HORDEUM
HORMONAL|ENDOCRINE
HORMONES|HORMONE
HORNERS|HORNER
HORNETS|HORNET
HORNS|HORN
HORSE|EQUINE
HORSES|EQUINE
HORSESICKNESSES|HORSESICKNESS
HOSPICES|HOSPICE
HOSPITAL|HOSP
HOSPITALIZATIONS|HOSPITALIZATION
HOSPITALS|HOSP
HOSPS|HOSP
HOSTILITY|HOSTILITIES
HOTLINES|HOTLINE
HOUSEFLY|HOUSEFLIES
HOUSEHOLDS|HOUSEHOLD
HOUSEKEEPINGS|HOUSEKEEPING
HOUSES|HOUSE
HOUSEWORKS|HOUSEWORK
HOUSINGS|HOUSING
HTN|HYPERTENSION
HUMANISMS|HUMANISM
HUMANITY|HUMANITIES
HUMERUS|HUMERAL
HUMIDITY|HUMIDITIES
HUMORS|HUMOR
HUMULONE|HUMULON
HUNDRED|100
HUNTERS|HUNTER
HUNTINGTONS|HUNTINGTON
HURLERS|HURLER
HURRICANES|HURRICANE
HUSBANDRY|HUSBANDRIES
HUTCHINSONS|HUTCHINSON
HX|HIST
HYALINOSIS|HYALINOSES
HYALURONIC|HYALURONATE
HYAMINE|HYAMIN
HYATT|HYATE
HYBRIDIZATIONS|HYBRIDIZATION
HYBRIDOMAS|HYBRIDOMA
HYBRIDS|HYBRID
HYDANPHENE|HYDANPHEN
HYDANTOINS|HYDANTOIN
HYDATIDOSIS|HYDATIDOSES
HYDRALLAZIN|HYDRALAZINE
HYDRAMNIOS|HYDRAMNIO
HYDRANENCEPHALY|HYDRANENCEPHALIES
HYDRARTHROSIS|HYDRARTHROSES
HYDRAS|HYDRA
HYDRASES|HYDRASE
HYDRATASES|HYDRATASE
HYDRAZIDES|HYDRAZIDE
HYDRAZINES|HYDRAZINE
HYDRAZONES|HYDRAZONE
HYDROCARBONS|HYDROCARBON
HYDROCELES|HYDROCELE
HYDROCEPHALY|HYDROCEPHALUS
HYDROCODONE|HYDROCODON
HYDROCOLLOIDS|HYDROCOLLOID
HYDROGENATIONS|HYDROGENATION
HYDROGENLYASES|HYDROGENLYASE
HYDROLASES|HYDROLASE
HYDROLYASES|HYDROLYASE
HYDROLYSATES|HYDROLYSATE
HYDROLYSINE|HYDROLYSIN
HYDROLYSIS|HYDROLYSES
HYDROMORPHONE|HYDROMORPHON
HYDRONEPHROSIS|HYDRONEPHROSES
HYDROPEROXIDES|HYDROPEROXIDE
HYDROPHOBIAS|HYDROPHOBIA
HYDROPNEUMOTHORAXS|HYDROPNEUMOTHORAX
HYDROQUINONES|HYDROQUINONE
HYDROTHERAPY|HYDROTHERAPIES
HYDROTHORAXS|HYDROTHORAX
HYDROXAMIC|HYDROXAMATE
HYDROXIDES|HYDROXIDE
HYDROXYANDROSTANES|HYDROXYANDROSTANE
HYDROXYANILINES|HYDROXYANILINE
HYDROXYAPATITES|HYDROXYAPATITE
HYDROXYASTEROLIDE|HYDROXYASTEROLID
HYDROXYBUTANES|HYDROXYBUTANE
HYDROXYBUTYRATES|HYDROXYBUTYRATE
HYDROXYBUTYRIC|HYDROXYBUTYRATE
HYDROXYCAMPTOTHECINE|HYDROXYCAMPTOTHECIN
HYDROXYCHOLECALCIFEROLS|HYDROXYCHOLECALCIFEROL
HYDROXYCHOLESTEROLS|HYDROXYCHOLESTEROL
HYDROXYCINNAMIC|HYDROXYCINNAMATE
HYDROXYCOBALAMIN|HYDROXOCOBALAMIN
HYDROXYCORTICOSTEROIDS|HYDROXYCORTICOSTEROID
HYDROXYCOUMARINS|HYDROXYCOUMARIN
HYDROXYDOCOSAHEXAENOIC|HYDROXYDOCOSAHEXAENOATE
HYDROXYDOPAMINES|HYDROXYDOPAMINE
HYDROXYESTRONES|HYDROXYESTRONE
HYDROXYHEMOPYRROLINE|HYDROXYHEMOPYRROLIN
HYDROXYHEXADECANOIC|HYDROXYHEXADECANOATE
HYDROXYHEXANES|HYDROXYHEXANE
HYDROXYHEXANOIC|HYDROXYHEXANOATE
HYDROXYISOVALERIC|HYDROXYISOVALERATE
HYDROXYLAMINES|HYDROXYLAMINE
HYDROXYLASES|HYDROXYLASE
HYDROXYLATIONS|HYDROXYLATION
HYDROXYLKINASE|HYDROXYKINASE
HYDROXYMERCURIBENZOATES|HYDROXYMERCURIBENZOATE
HYDROXYMETHYLPYRIDINE|HYDROXYMETHYLPYRDINE
HYDROXYNAPHTHALENES|HYDROXYNAPHTHALENE
HYDROXYPENTANES|HYDROXYPENTANE
HYDROXYPHENYLGLYOXYLIC|HYDROXYPHENYLGLYOXYLATE
HYDROXYPHENYLPYRUVIC|HYDROXYPHENYLPYRUVATE
HYDROXYPROGESTERONES|HYDROXYPROGESTERONE
HYDROXYPROPIONIC|HYDROXYPROPIONATE
HYDROXYPYRIDINE|HYDROXYPYRIDIN
HYDROXYPYRIDINES|HYDROXYPYRIDIN
HYDROXYQUINOLINES|HYDROXYQUINOLINE
HYDROXYSTEROIDS|HYDROXYSTEROID
HYDROXYSULFONIC|HYDROXYSULFONATE
HYDROXYTESTOSTERONES|HYDROXYTESTOSTERONE
HYDROXYVITAMINS|HYDROXYVITAMIN
HYGIENES|HYGIENE
HYGIENISTS|HYGIENIST
HYLOBATES|HYLOBATE
HYMENOLEPIASIS|HYMENOLEPIASES
HYMENOPTERAS|HYMENOPTERA
HYMENS|HYMEN
HYPERACTIVITY|HYPERACTIVITIES
HYPERALGESIAS|HYPERALGESIA
HYPERALIMENTATIONS|HYPERALIMENTATION
HYPERBETALIPOPROTEINEMIAS|HYPERBETALIPOPROTEINEMIA
HYPERBILIRUBINEMIA|BILIRUBINEMIA
HYPERBILIRUBINEMIAS|BILIRUBINEMIA
HYPERCALCEMIAS|HYPERCALCEMIA
HYPERCAPNIAS|HYPERCAPNIA
HYPERCEMENTOSIS|HYPERCEMENTOSES
HYPERCHOLESTEREMIAS|HYPERCHOLESTEREMIA
HYPERCHOLESTEROLEMIA|HYPERCHOLESTEROLEM
HYPERCHOLESTEROLEMIAS|HYPERCHOLESTEROLEM
HYPERCHYLOMICRONEMIAS|HYPERCHYLOMICRONEMIA
HYPERCORTICISMS|HYPERCORTICISM
HYPEREMIAS|HYPEREMIA
HYPERESTHESIAS|HYPERESTHESIA
HYPERFUNCTIONS|HYPERFUNCTION
HYPERGAMMAGLOBULINEMIAS|HYPERGAMMAGLOBULINEMIA
HYPERGLYCEMIAS|HYPERGLYCEMIA
HYPERHIDROSIS|HYPERHIDROSES
HYPERINSULINISMS|HYPERINSULINISM
HYPERKERATOSIS|HYPERKERATOSES
HYPERKINESIAS|HYPERKINESIA
HYPERKINESIS|HYPERKINESES
HYPERLIPEMIAS|HYPERLIPEMIA
HYPERLIPIDEMIAS|HYPERLIPIDEMIA
HYPERLIPOPROTEINEMIAS|HYPERLIPOPROTEINEMIA
HYPERMENORRHEAS|HYPERMENORRHEA
HYPERMOBILITY|HYPERMOBILITIES
HYPERNATREMIAS|HYPERNATREMIA
HYPERNEPHROMAS|HYPERNEPHROMA
HYPEROSTOSIS|HYPEROSTOSES
HYPEROXALURIAS|HYPEROXALURIA
HYPERPARATHYROIDISMS|HYPERPARATHYROIDISM
HYPERPHAGIAS|HYPERPHAGIA
HYPERPITUITARISMS|HYPERPITUITARISM
HYPERPLASIAS|HYPERPLASIA
HYPERPREBETALIPOPROTEINEMIAS|HYPERPREBETALIPOPROTEINEMIA
HYPERPROLACTINEMIAS|HYPERPROLACTINEMIA
HYPERPYREXIA|FEBRILE
HYPERPYREXIAS|FEBRILE
HYPERSALIVATIONS|HYPERSALIVATION
HYPERSENSITIVITY|HYPERSENSITIVITIES
HYPERSOMNIAS|HYPERSOMNIA
HYPERSPLENISMS|HYPERSPLENISM
HYPERTELORISMS|HYPERTELORISM
HYPERTENSIONS|HYPERTENSION
HYPERTHERMIA|FEBRILE
HYPERTHERMIAS|FEBRILE
HYPERTHYROXINEMIAS|HYPERTHYROXINEMIA
HYPERTONIAS|HYPERTONIA
HYPERTONICITY|HYPERTONIA
HYPERTRICHOSIS|HYPERTRICHOSES
HYPERTRIGLYCERIDEMIAS|HYPERTRIGLYCERIDEMIA
HYPERTROPHIC|HYPERTR
HYPERTROPHIES|HYPERTROPH
HYPERTROPHY|HYPERTROPH
HYPERTROPIAS|HYPERTROPIA
HYPERVENTILATIONS|HYPERVENTILATION
HYPESTHESIAS|HYPESTHESIA
HYPHEMAS|HYPHEMA
HYPNOSIS|HYPNOSES
HYPNOTICS|HYPNOTIC
HYPOALDOSTERONISMS|HYPOALDOSTERONISM
HYPOBETALIPOPROTEINEMIAS|HYPOBETALIPOPROTEINEMIA
HYPOCALCEMIAS|HYPOCALCEMIA
HYPOCHONDRIASES|HYPOCHONDRIA
HYPOCHONDRIASIS|HYPOCHONDRIA
HYPODERMYIASIS|HYPODERMYIASES
HYPODONTIAS|HYPODONTIA
HYPOFUNCTIONS|HYPOFUNCTION
HYPOGALACTIAS|HYPOGALACTIA
HYPOGAMMAGLOBULINEMIAS|HYPOGAMMAGLOBULINEMIA
HYPOGLYCEMIAS|HYPOGLYCEMIA
HYPOGLYCEMIC|HYPOGLYCEMIA
HYPOGLYCINS|HYPOGLYCIN
HYPOGONADISMS|HYPOGONADISM
HYPOHIDROSIS|HYPOHIDROSES
HYPOLIPOPROTEINEMIAS|HYPOLIPOPROTEINEMIA
HYPOMENORRHEAS|HYPOMENORRHEA
HYPONATREMIAS|HYPONATREMIA
HYPOPARATHYROIDISMS|HYPOPARATHYROIDISM
HYPOPHARYNX|HYPOPHARYNGES
HYPOPHARYNXES|HYPOPHARYNGES
HYPOPHOSPHATASIAS|HYPOPHOSPHATASIA
HYPOPHOSPHATEMIAS|HYPOPHOSPHATEMIA
HYPOPHYSECTOMY|HYPOPHYSECTOMIES
HYPOPHYSIS|HYPOPHYSES
HYPOPITUITARISMS|HYPOPITUITARISM
HYPOPLASIAS|HYPOPLASIA
HYPOPLASIS|HYPOPLASIA
HYPOPROCONVERTINEMIAS|HYPOPROCONVERTINEMIA
HYPOPROTEINEMIAS|HYPOPROTEINEMIA
HYPOPROTHROMBINEMIAS|HYPOPROTHROMBINEMIA
HYPOSALIVATIONS|HYPOSALIVATION
HYPOSPADIAS|HYPOSPADIA
HYPOSTASIS|HYPOSTASES
HYPOTENSIONS|HYPOTENSION
HYPOTENSIVE|HYPOTENSION
HYPOTHALAMUS|HYPOTHALAMIC
HYPOTHERMIAS|HYPOTHERMIA
HYPOTHESIS|HYPOTHESES
HYPOTHYROIDISM|CRETINISM
HYPOTHYROIDISMS|CRETINISM
HYPOTONIAS|HYPOTONIA
HYPOTONICITY|HYPOTONIA
HYPOTONY|HYPOTONIA
HYPOTRICHOSIS|HYPOTRICHOSES
HYPOVENTILATIONS|HYPOVENTILATION
HYPOXANTHINES|HYPOXANTHINE
HYPOXEMIAS|HYPOXEMIA
HYPOXIAS|HYPOXIA
HYPSARRHYTHMIAS|HYPSARRHYTHMIA
HYRAXES|HYRAX
HYSTERECTOMY|HYSTERECTOMIES
HYSTERIAS|HYSTERIA
HYSTEROSALPINGOGRAPHY|HYSTEROSALPINGOGRAPHIES
HYSTEROSCOPY|HYSTEROSCOPIES
HYSTEROTOMY|HYSTEROTOMIES
HYSTRIX|HYSTRICES
I|1
ICES|ICE
ICHTHYOSIS|ICHTHYOSES
ICHTIOMICINE|ICHTIOMICIN
ICOMPS|ICOMP
ICTAL|CONVULSION
ICTEROHEMORRHAGICA|ICTEROHEMORRHAGIC
IDDMS|IDDM
IDENTIFICATIONS|IDENTIFICATION
IDENTITY|IDENTITIES
IDIOCY|IDIOCIES
IDIOTYPES|IDIOTYPE
IDIOTYPIC|IDIOTYPE
IDS|ID
IGUANAS|IGUANA
II|2
III|3
IISHRS|IISHR
ILEITIS|ILEITIDES
ILEOCOLITIS|ILEOCOLITIDES
ILEOSTOMY|ILEOSTOMIES
ILEUM|ILEAL
ILIUMS|ILIUM
ILLEGAL|CRIMINAL
ILLEGITIMACY|ILLEGITIMACIES
ILLNESSES|ILLNESS
ILLS|ILL
ILLUMINATIONS|ILLUMINATION
ILLUSIONS|ILLUSION
ILLUSTRATIONS|ILLUSTRATION
IMAGERY|IMAGERIES
IMAGES|IMAGE
IMAGINATIONS|IMAGINATION
IMAGINGS|IMAGING
IMBALANCE|EQUILIBRIA
IMBALANCES|EQUILIBRIA
IMFILINE|IMFILIN
IMIDATES|IMIDATE
IMIDAZOLE|IMIDAZOL
IMIDAZOLES|IMIDAZOL
IMINES|IMINE
IMMERSIONS|IMMERSION
IMMIGRATIONS|IMMIGRATION
IMMOBILIZATIONS|IMMOBILIZATION
IMMUNITY|IMMUNITIES
IMMUNIZATIONS|IMMUNIZATION
IMMUNOADSORBENTS|IMMUNOADSORBENT
IMMUNOASSAY|IMMUNOASSAIES
IMMUNOASSAYS|IMMUNOASSAIES
IMMUNOBLASTOMAS|IMMUNOBLASTOMA
IMMUNOBLOTTING|IMMUNOBLOT
IMMUNOBLOTTINGS|IMMUNOBLOT
IMMUNOCHEMISTRIES|IMMUNOCHEM
IMMUNOCHEMISTRY|IMMUNOCHEM
IMMUNOCOMPETENCES|IMMUNOCOMPETENCE
IMMUNOCONTRACEPTIONS|IMMUNOCONTRACEPTION
IMMUNOCYTOADHERENCES|IMMUNOCYTOADHERENCE
IMMUNOCYTOCHEMISTRIES|IMMUNOCYTOCHEM
IMMUNOCYTOCHEMISTRY|IMMUNOCYTOCHEM
IMMUNODEFICIENCY|IMMUNODEFIC
IMMUNODIAGNOSES|IMMUNODIAG
IMMUNODIAGNOSIS|IMMUNODIAG
IMMUNODIFFUSIONS|IMMUNODIFFUSION
IMMUNOELECTROBLOTTING|IMMUNOELECTROBLOT
IMMUNOELECTROBLOTTINGS|IMMUNOELECTROBLOT
IMMUNOELECTROOSMOPHORESIS|IMMUNOELECTROOSMOPHORESES
IMMUNOELECTROPHORESIS|IMMUNOELECTROPHORESES
IMMUNOGENETICS|IMMUNOGENET
IMMUNOGLOBIN|IG
IMMUNOGLOBULINS|IMMUNOGLOBULIN
IMMUNOHISTOCHEMISTRIES|IMMUNOHISTOCHEM
IMMUNOHISTOCHEMISTRY|IMMUNOHISTOCHEM
IMMUNOHISTOCYTOCHEMISTRIES|IMMUNOHISTOCYTOCHEM
IMMUNOHISTOCYTOCHEMISTRY|IMMUNOHISTOCYTOCHEM
IMMUNOLOGIC|IMMUNOL
IMMUNOLOGICAL|IMMUNOL
IMMUNOLOGIES|IMMUNOL
IMMUNOLOGY|IMMUNOL
IMMUNOMODULATORS|IMMUNOMOD
IMMUNOPHENOTYPINGS|IMMUNOPHENOTYPING
IMMUNOPRECIPITATIONS|IMMUNOPRECIPITATION
IMMUNOREACTIVITY|IMMUNOREACTANTS
IMMUNOSORBENTS|IMMUNOSORBENT
IMMUNOSTIMULATIONS|IMMUNOSTIMULATION
IMMUNOSUPPRESSIONS|IMMUNOSUPPRESSION
IMMUNOSUPPRESSIVES|IMMUNOSUPPRESSIVE
IMMUNOSURVEILLANCES|IMMUNOSURVEILLANCE
IMMUNOTHERAPIES|IMMUNOTHER
IMMUNOTHERAPY|IMMUNOTHER
IMMUNOTOXINS|IMMUNOTOXIN
IMPACTION|IMPACTED
IMPACTS|IMPACT
IMPAIRMENT|IMPAIRED
IMPAIRMENTS|IMPAIRED
IMPEDANCES|IMPEDANCE
IMPERFECTAS|IMPERFECTA
IMPERFORATIONS|IMPERFORATION
IMPETIGOS|IMPETIGO
IMPLANTABLE|IMPLANT
IMPLANTATION|IMPLANT
IMPLANTATIONS|IMPLANT
IMPLANTS|IMPLANT
IMPLEMENTATIONS|IMPLEMENTATION
IMPORTATIONS|IMPORTATION
IMPOTENCES|IMPOTENCE
IMPOTENT|IMPOTENCE
IMPRESSIONS|IMPRESSION
IMPRINTS|IMPRINT
IMURAN|IMMURAN
INACTIVATIONS|INACTIVATION
INACTIVATORS|INACTIVATOR
INANITIONS|INANITION
INBREEDINGS|INBREEDING
INCAPS|INCAP
INCENTIVES|INCENTIVE
INCESTS|INCEST
INCIDENCES|INCIDENCE
INCISORS|INCISOR
INCLUSIONS|INCLUSION
INCOHERENT|INCOHERENCE
INCOMES|INCOME
INCOMPATIBILITY|INCOMPATIBILITIES
INCOMPETENCES|INCOMPETENCE
INCOMPETENCY|INCOMPETENCE
INCOMPETENT|INCOMPETENCE
INCONSTANS|INCONSTAN
INCONTINENCES|INCONTINENCE
INCONTINENT|INCONTINENCE
INCOORDINATION|ATAXIA
INCREASES|INCREASE
INCUBATORS|INCUBATOR
INCUNABULAS|INCUNABULA
INDANAZOLINE|INDANAZOLIN
INDANS|INDAN
INDAZOLES|INDAZOLE
INDENES|INDENE
INDEPENDENCES|INDEPENDENCE
INDEXE|INDEX
INDEXES|INDEX
INDEXINGS|INDEXING
INDIANS|INDIAN
INDICATIONS|INDICATION
INDICATORS|INDICATOR
INDICE|INDEX
INDICES|INDEX
INDIGENCY|INDIGENCIES
INDIGENTS|INDIGENT
INDIGESTION|DYSPEPSIA
INDIVIDUALITY|INDIVIDUALITIES
INDIVIDUATIONS|INDIVIDUATION
INDOLE|INDOL
INDOLES|INDOL
INDOLIZINES|INDOLIZINE
INDOLYLACETIC|INDOLEACETIC
INDRUS|INDRI
INDUCERS|INDUCER
INDUCTIONS|INDUCTION
INDURATIONS|INDURATION
INDURATUMS|INDURATUM
INDUSTRIALIZATIONS|INDUSTRIALIZATION
INDUSTRY|INDUSTRIES
INEQUALITY|INEQUALITIES
INERTIAS|INERTIA
INFANT|BABY
INFANTICIDES|INFANTICIDE
INFANTILISMS|INFANTILISM
INFANTS|BABY
INFARCTION|INFARCT
INFARCTIONS|INFARCT
INFARCTS|INFARCT
INFECTED|INFECT
INFECTION|INFECT
INFECTIONS|INFECT
INFECTIOUS|INFECT
INFECTIVE|INFECT
INFECTS|INFECT
INFERTILITY|INFERTILITIES
INFESTATIONS|INFESTATION
INFLAMM|INFLAM
INFLAMMATIONS|INFLAMMATION
INFLAMMATORY|INFLAM
INFLAMMED|INFLAMMATION
INFLATIONS|INFLATION
INFLUENCING|AFFECTING
INFLUENTIALS|INFLUENTIAL
INFLUENZAL|INFLUENZA
INFLUENZAS|INFLUENZA
INFORMATICS|INFORMATIC
INFORMATIONS|INFORMATION
INFUSIONS|INFUSION
INFUSORS|INFUSOR
INGROWN|INGROWING
INGUINAL|GROIN
INHALATION|INHAL
INHALATIONS|INHAL
INHALATORS|INHALATOR
INHALERS|INHALER
INHALINGS|INHALING
INHERITANCES|INHERITANCE
INHERITED|HERED
INHIB|INACTIVATOR
INHIBITING|INACTIVATOR
INHIBITION|INACTIVATOR
INHIBITIONS|INACTIVATOR
INHIBITOR|INACTIVATOR
INHIBITORS|INACTIVATOR
INHIBITORY|INACTIVATOR
INITIATIONS|INITIATION
INITIATORS|INITIATOR
INJECTABLE|INJECT
INJECTION|INJECT
INJECTIONS|INJECT
INJURIES|INJ
INJURY|INJ
INKS|INK
INLAYS|INLAY
INNOCENT|BENIGN
INNOMINATAS|INNOMINATA
INNOVATIONS|INNOVATION
INORGANIC|INORG
INOSITOL|INOSITIOL
INOTROPISMS|INOTROPISM
INPATIENTS|INPATIENT
INPUTS|INPUT
INSECTICIDES|INSECTICIDE
INSECTIVORAS|INSECTIVORA
INSECTS|INSECT
INSEMINATIONS|INSEMINATION
INSENSITIVITY|INSENSITIVITIES
INSERTIONS|INSERTION
INSERTS|INSERT
INSIGNIAS|INSIGNIA
INSOLVENCY|INSOLVENCIES
INSOMNIAS|INSOMNIA
INSPECT|AUDIT
INSPECTIONS|INSPECTION
INSTABILITY|INSTABILITIES
INSTILLATIONS|INSTILLATION
INSTINCTS|INSTINCT
INSTITUTES|INSTITUTE
INSTITUTIONALIZATIONS|INSTITUTIONALIZATION
INSTITUTIONS|INSTITUTION
INSTRUCTIONS|INSTRUCTION
INSTRUCTORS|INSTRUCTOR
INSTRUMENT|INSTRUM
INSTRUMENTAL|INSTRUM
INSTRUMENTS|INSTRUM
INSUFFICIENCIES|INSUFFIC
INSUFFICIENCY|INSUFFIC
INSUFFLATIONS|INSUFFLATION
INSUFFLATORS|INSUFFLATOR
INSULAS|INSULA
INSULINOMAS|INSULINOMA
INSULOMA|INSULINOMA
INSULOMAS|INSULINOMA
INSURANCE|INSUR
INSURANCES|INSUR
INSURERS|INSURER
INTAKES|INTAKE
INTEGRATIONS|INTEGRATION
INTEGRINS|INTEGRIN
INTELLIGENCES|INTELLIGENCE
INTELLIGIBILITY|INTELLIGIBILITIES
INTERACTIONS|INTERACTION
INTERCONNECTIONS|INTERCONNECTION
INTERCOURSE|COITUS
INTERFACES|INTERFACE
INTERFERENCES|INTERFERENCE
INTERFEROMETRY|INTERFEROMETRIES
INTERFERONS|INTERFERON
INTERLEUKIN|IL
INTERLEUKINS|IL
INTERMARRIAGES|INTERMARRIAGE
INTERMEDIATE|INTERMED
INTERMITTENT|INTERMITT
INTERNAS|INTERNA
INTERNEURONS|INTERNEURON
INTERNSHIPS|INTERNSHIP
INTERPHASES|INTERPHASE
INTERPRETATION|INTERP
INTERPRETATIONS|INTERP
INTERSEXUALITY|INTERSEXUALITIES
INTERTRIGOS|INTERTRIGO
INTERVALS|INTERVAL
INTERVENTIONS|INTERVENTION
INTERVIEWERS|INTERVIEWER
INTERVIEWS|INTERVIEW
INTESTINAL|BOWEL
INTESTINALIS|INTESTINALI
INTESTINE|BOWEL
INTESTINES|BOWEL
INTOLERANCE|INTOLERAN
INTOLERANCES|INTOLERAN
INTOXICATION|INTOX
INTOXICATIONS|INTOX
INTRAOCULAR|EYE
INTRAOPERATIVE|INTRAOP
INTRAVASCULAR|INTRAVASC
INTRONS|INTRON
INTUBATIONS|INTUBATION
INTUSSUSCEPTIONS|INTUSSUSCEPTION
INTUSUSCEPTION|INTUSSUSCEPTION
INTUSUSCEPTIONS|INTUSSUSCEPTION
INVASIVENESSES|INVASIVENESS
INVENTORY|INVENTORIES
INVERTEBRATES|INVERTEBRATE
INVESTIGATORS|INVESTIGATOR
INVESTMENTS|INVESTMENT
INVOLUTIONAL|INVOLUTION
INVOLVEMENTS|INVOLVEMENT
IODAMOEBIASIS|IODAMOEBIASES
IODATES|IODATE
IODIDES|IODIDE
IODIPINE|IODIPIN
IODOACETATES|IODOACETATE
IODOBENZENES|IODOBENZENE
IODOBENZOATES|IODOBENZOATE
IODOPROPIONIC|IODOPROPIONATE
IONIC|ION
IONIZATIONS|IONIZATION
IONOPHORES|IONOPHORE
IONS|ION
IONTOPHORESIS|IONTOPHORESES
IOTHALAMATE|IOTALAMATE
IPODATE|IOPODATE
IPPBS|IPPB
IPPFS|IPPF
IPPVS|IPPV
IPRATROPIUM|IPRATROPIN
IRELAND|EIRE
IRIDOCYCLITIS|IRIDOCYCLITIDES
IRIDOVIRUSES|IRIDOVIRUS
IRITIS|IRITIDES
IRON|FERRIC
IRRADIATION|IRRAD
IRRADIATIONS|IRRAD
IRRIGATIONS|IRRIGATION
ISCHEMIAS|ISCHEMIA
ISCHIUMS|ISCHIUM
ISLAMS|ISLAM
ISLANDS|ISLAND
ISLETS|ISLET
ISOANTIBODY|ISOANTIBODIES
ISOCITRATES|ISOCITRATE
ISOCYANIDES|ISOCYANIDE
ISOENZYMES|ISOENZYME
ISOFLAVONES|ISOFLAVONE
ISOGENEIC|ISOGEN
ISOGRAFTS|ISOGRAFT
ISOIMMUNIZATIONS|ISOIMMUNIZATION
ISOLATIONS|ISOLATION
ISOLATORS|ISOLATOR
ISOLECTINS|ISOLECTIN
ISOLEUCYL|ISOLEUCINE
ISOMERASES|ISOMERASE
ISOMERISMS|ISOMERISM
ISONIAZIDE|ISONIAZID
ISONIXINE|ISONIXIN
ISOPHOSPHAMIDE|ISOFOSFAMIDE
ISOPROTEINS|ISOPROTEIN
ISOPTINE|ISOPTIN
ISOPYRINE|ISOPYRIN
ISOQUINOLINES|ISOQUINOLINE
ISOSITE|ISOSIT
ISOTACHOPHORESIS|ISOTACHOPHORESES
ISOTHIOBARBAMINE|ISOTHIOBARBAMIN
ISOTOPES|ISOTOPE
ISOXAZOLES|ISOXAZOLE
ISOZYMES|ISOZYME
ISSUES|ISSUE
ITCHING|PRURITUS
ITCHINGS|PRURITUS
ITEMS|ITEM
IUDS|IUD
IUGRS|IUGR
IV|4
IZADRIN|ISADRINE
IZOPTIN|ISOPTIN
JAAGSIEKTES|JAAGSIEKTE
JACKETS|JACKET
JAPONICAS|JAPONICA
JAPONICUM|JAPONICA
JAUNDICES|JAUNDICE
JAWS|JAW
JEALOUSY|JEALOUSIES
JEGHERS|JEGHER
JEHOVAHS|JEHOVAH
JEJUNOSTOMY|JEJUNOSTOMIES
JEJUNUMS|JEJUNUM
JELLY|JELLIES
JELLYFISHS|JELLYFISH
JERKINGS|JERKING
JERNES|JERNE
JEWS|JEW
JIRDS|JIRD
JOBS|JOB
JOGGINGS|JOGGING
JOHNES|JOHNE
JOINT|ARTICULAR
JOINTS|ARTICULAR
JOSAMYCINE|JOSAMYCIN
JUDGMENTS|JUDGMENT
JUGULARES|JUGULARE
JUICES|JUICE
JUNCTIONS|JUNCTION
JUSTICES|JUSTICE
KANGAROOS|KANGAROO
KANNERS|KANNER
KAPOSIS|KAPOSI
KARTAGENERS|KARTAGENER
KARYOKINESIS|KARYOKINESES
KARYOMETRY|KARYOMETRIES
KARYOTYPES|KARYOTYPE
KARYOTYPINGS|KARYOTYPING
KASHIN|KASCHIN
KAVAINE|KAVAIN
KEARNS|KEARN
KELOIDS|KELOID
KELTHANE|KELTANE
KENYAS|KENYA
KERATINOCYTES|KERATINOCYTE
KERATITIS|KERATITIDES
KERATOACANTHOMAS|KERATOACANTHOMA
KERATOCONJUNCTIVITIS|KERATOCONJUNCTIVITIDES
KERATODERMAS|KERATODERMA
KERATODERMIA|KERATODERMA
KERATOPLASTY|KERATOPLASTIES
KERATOSIS|KERATOSES
KERATOTIC|KERATOSES
KERATOTOMY|KERATOTOMIES
KEROSENES|KEROSENE
KEROSINE|KEROSENE
KEROSINES|KEROSENE
KETANSET|KETANEST
KETOACIDURIAS|KETOACIDURIA
KETOCHOLESTEROLS|KETOCHOLESTEROL
KETOGLUCONIC|KETOGLUCONATE
KETOGLUTARIC|KETOGLUTARATE
KETOHEXOKINASES|KETOHEXOKINASE
KETOISOCAPROIC|KETOISOCAPROATE
KETOISOVALERIC|KETOISOVALERATE
KETOLS|KETOL
KETONES|KETONE
KETOSIS|KETOSES
KETOSTEROIDS|KETOSTEROID
KETOTIFENE|KETOTIFEN
KETOTIPHEN|KETOTIFEN
KETOTIPHENE|KETOTIFEN
KIDNEY|KIDNEIES
KIDNEYS|KIDNEIES
KIENBOECKS|KIENBOECK
KILLIFISHS|KILLIFISH
KILLINGS|KILLING
KINASES|KINASE
KINESICS|KINESIC
KINESIS|KINESES
KINESTHESIS|KINESTHESES
KINETICS|KINETIC
KINETOCARDIOGRAPHY|KINETOCARDIOGRAPHIES
KININOGENS|KININOGEN
KININS|KININ
KITAZINE|KITAZIN
KITS|KIT
KLEINS|KLEIN
KLINEFELTERS|KLINEFELTER
KNEES|KNEE
KNIVES|KNIFE
KNUCKLE|INTERPHALANGEAL
KOEHLERS|KOEHLER
KOSHLANDS|KOSHLAND
KRABBES|KRABBE
KRAUSES|KRAUSE
KRILLS|KRILL
KURUS|KURU
KWASHIORKORS|KWASHIORKOR
KYMOGRAPHY|KYMOGRAPHIES
KYPHOSIS|KYPHOSES
L1210S|L1210
L5178S|L5178
LABELINGS|LABELING
LABELLED|LABELED
LABELLING|LABELING
LABELLINGS|LABELING
LABETOLOL|LABETALOL
LABORATORY|LABORATORIES
LABORS|LABOR
LABOUR|LABOR
LABYRINTHITIS|LABYRINTHITIDES
LABYRINTHS|LABYRINTH
LACERATIONS|LACERATION
LACQUERS|LACQUER
LACRIMATION|LACRIMAL
LACRIMATORS|LACRIMATOR
LACROSSES|LACROSSE
LACTAMASES|LACTAMASE
LACTAMS|LACTAM
LACTASES|LACTASE
LACTATES|LACTATE
LACTATIONS|LACTATION
LACTIC|LACTATE
LACTOFERRINS|LACTOFERRIN
LACTOGLOBULINS|LACTOGLOBULIN
LACTONES|LACTONE
LACTOSE|DISACCHARIDE
LACTOSIDES|LACTOSIDE
LACTOSYLCERAMIDES|LACTOSYLCERAMIDE
LADDERS|LADDER
LADY|FEMALE
LAEVIS|LAEVI
LAGOMORPHAS|LAGOMORPHA
LAGOMORPHS|LAGOMORPH
LAGOTHRIX|LAGOTHRICES
LAKES|LAKE
LAMBDAS|
LAMBDA
LAMBLIASIS|LAMBLIASES
LAMENESSES|LAMENESS
LAMINAGRAPHY|LAMINAGRAPHIES
LAMINAS|LAMINA
LAMINECTOMY|LAMINECTOMIES
LAMPREYS|LAMPREY
LANATOSIDES|LANATOSIDE
LANGES|LANGE
LANGUAGES|LANGUAGE
LANGURS|LANGUR
LANTHANIDES|LANTHANIDE
LANUGOS|LANUGO
LAPAROSCOPES|LAPAROSCOPE
LAPAROSCOPY|LAPAROSCOPIES
LAPAROTOMY|LAPAROTOMIES
LARGENESS|LARGE
LARVAS|LARVA
LARYNGECTOMY|LARYNGECTOMIES
LARYNGES|LARYNGEAL
LARYNGITIS|LARYNGITIDES
LARYNGOPHARYNX|LARYNGOPHARYNGES
LARYNGOPHARYNXES|LARYNGOPHARYNGES
LARYNGOSCOPY|LARYNGOSCOPIES
LARYNGOSPASMS|LARYNGOSPASM
LARYNGOSTENOSIS|LARYNGOSTENOSES
LARYNX|LARYNGEAL
LARYNXS|LARYNGEAL
LASERS|LASER
LASIX|DIURETIC
LASSARS|LASSAR
LASSITUDES|LASSITUDE
LATAS|LATA
LATENCY|LATENCIES
LATERALITY|LATERALITIES
LATHYRISMS|LATHYRISM
LATICES|LATEX
LATRINES|LATRINE
LATTICES|LATTICE
LAUGHTERS|LAUGHTER
LAUNDERINGS|LAUNDERING
LAURATES|LAURATE
LAVAGES|LAVAGE
LAW|BYLAW
LAWS|BYLAW
LAXATIVES|LAXATIVE
LAXITY|LAXITIES
LAYERS|LAYER
LEADERSHIPS|LEADERSHIP
LEAKADINE|LEAKADIN
LEAKAGES|LEAKAGE
LEARNED|CONDITIONED
LEARNINGS|LEARNING
LEASINGS|LEASING
LEBERS|LEBER
LEBISTES|LEBISTE
LECITHINASES|LECITHINASE
LECITHINS|LECITHIN
LECTINS|LECTIN
LEECHES|LEECH
LEGALLY|LEGAL
LEGIONELLOSIS|LEGIONELLOSES
LEGIONNAIRES|LEGIONNAIRE
LEGISLATION|LEGIS
LEGISLATIONS|LEGIS
LEGITIMACY|LEGITIMACIES
LEGS|LEG
LEGUME|BEAN
LEGUMES|BEAN
LEGUMINOSAE|BEAN
LEIOCARPOSIDE|LEIOCARPOSID
LEIOMYOMAS|LEIOMYOMA
LEIOMYOSARCOMAS|LEIOMYOSARCOMA
LEISHMANIASIS|LEISHMANIASES
LEISURES|LEISURE
LEMMINGS|LEMMING
LEMURIFORMES|LEMURIFORME
LEMUROIDEAS|LEMUROIDEA
LEMURS|LEMUR
LENGTHENINGS|LENGTHENING
LENGTHS|LENGTH
LENINISMS|LENINISM
LENS|LEN
LENSE|LEN
LENSES|LEN
LENTIGOS|LENTIGO
LENTILS|LENTIL
LENTIVIRUSES|LENTIVIRUS
LEONTIDEUS|LEONTIDEU
LEPIDOPTERAS|LEPIDOPTERA
LEPROSY|LEPROSIES
LEPTOCONOPS|LEPTOCONOP
LEPTOSPIROSIS|LEPTOSPIROSES
LERICHES|LERICHE
LESBIANISMS|LESBIANISM
LESIONS|LESION
LETHARGY|LETHARGIES
LETTERS|LETTER
LEUCINE|LEU
LEUCOMALACIAS|LEUCOMALACIA
LEUCOMYCINS|LEUCOMYCIN
LEUCOSARCOMAS|LEUCOSARCOMA
LEUCOTOMY|LEUCOTOMIES
LEUCYL|LEU
LEUKAPHERESIS|LEUKAPHERESES
LEUKEMIAS|LEUKEMIA
LEUKOCIDINS|LEUKOCIDIN
LEUKOCTYTE|GRANULOCYTE
LEUKOCYTAPHERESIS|LEUKOCYTAPHERESES
LEUKOCYTE|LEUKOCTYE
LEUKOCYTES|LEUKOCTYE
LEUKOCYTOPHERESES|LEUKOCYTAPHERESES
LEUKOCYTOPHERESIS|LEUKOCYTAPHERESES
LEUKOCYTOSIS|LEUKOCYTOSES
LEUKODYSTROPHY|LEUKODYSTROPHIES
LEUKOEDEMAS|LEUKOEDEMA
LEUKOENCEPHALOPATHIES|LEUKOENCEP
LEUKOENCEPHALOPATHY|LEUKOENCEP
LEUKOKININ|LEUCOKININ
LEUKOMALACIA|LEUCOMALACIA
LEUKOMALACIAS|LEUCOMALACIA
LEUKOMAS|LEUKOMA
LEUKONOSTOC|LEUCONOSTOC
LEUKOPENIAS|LEUKOPENIA
LEUKOPHERESES|LEUKAPHERESES
LEUKOPHERESIS|LEUKAPHERESES
LEUKOPLAKIAS|LEUKOPLAKIA
LEUKORRHEAS|LEUKORRHEA
LEUKOSARCOMA|LEUCOSARCOMA
LEUKOSARCOMAS|LEUCOSARCOMA
LEUKOSIS|LEUKOSES
LEUKOTAXIS|LEUKOTAXI
LEUKOTOMIES|LEUCOTOMIES
LEUKOTOMY|LEUCOTOMIES
LEUKOTRIENES|LEUKOTRIENE
LEUKOVIRUSES|LEUKOVIRUS
LEUKOVORIN|LEUCOVORIN
LEUKOVORUM|LEUCOVORIN
LEUPEPTINS|LEUPEPTIN
LEVANS|LEVAN
LEVELS|
LEVEL
LEVOCARDIAS|LEVOCARDIA
LEVOPROMAZINE|LEVOMEPROMAZINE
LEVORINE|LEVORIN
LEWANDOWSKY|LEWANDOWSKI
LIABILITY|LIABILITIES
LIBERALISMS|LIBERALISM
LIBERATIONS|LIBERATION
LIBIDOS|LIBIDO
LIBRARIANS|LIBRARIAN
LIBRARY|LIBRARIES
LICENSES|LICENSE
LICENSURES|LICENSURE
LICHENS|LICHEN
LID|EYELID
LIECHTENSTEIN|LEICHTENSTEIN
LIFES|LIFE
LIFTINGS|LIFTING
LIFTS|LIFT
LIGAMENTS|LIGAMENT
LIGANDINS|LIGANDIN
LIGANDS|LIGAND
LIGASES|LIGASE
LIGATIONS|LIGATION
LIGATURES|LIGATURE
LIGHTINGS|LIGHTING
LIGHTNESS|LIGHT
LIGHTNINGS|LIGHTNING
LIGHTS|LIGHT
LIGNINS|LIGNIN
LIMBS|LIMB
LIMENS|LIMEN
LIMITINGS|LIMITING
LINENS|LINEN
LINERS|LINER
LINES|LINE
LINESTRENOL|LINESTEROL
LINGUISTICS|LINGUISTIC
LININGS|LINING
LINKAGES|LINKAGE
LINSEEDS|LINSEED
LIONS|LION
LIPASES|LIPASE
LIPECTOMY|LIPECTOMIES
LIPEMIA|HYPERLIPIDEMIA
LIPIDOSIS|LIPIDOSES
LIPIDS|LIPID
LIPIODOLS|LIPIODOL
LIPOCHONDRODYSTROPHY|LIPOCHONDRODYSTROPHIES
LIPOCORTINS|LIPOCORTIN
LIPODYSTROPHY|LIPODYSTROPHIES
LIPOFUSCINOSIS|LIPOFUSCINOSES
LIPOFUSCINS|LIPOFUSCIN
LIPOGLYCANS|LIPOGLYCAN
LIPOID|OBESITIES
LIPOIDICAS|LIPOIDICA
LIPOIDOSES|LIPIDOSES
LIPOIDOSIS|LIPIDOSES
LIPOIDPROTEINOSIS|LIPOIDPROTEINOSES
LIPOLYSIS|LIPOLYSES
LIPOMAS|LIPOMA
LIPOMATOSIS|LIPOMATOSES
LIPOMUCOPOLYSACCHARIDOSIS|LIPOMUCOPOLYSACCHARIDOSES
LIPOMULS|LIPOMUL
LIPOPIGMENTS|LIPOPIGMENT
LIPOPOLYSACCHARIDES|LIPOPOLYSACCHARIDE
LIPOPROTEINS|LIPOPROTEIN
LIPOSARCOMAS|LIPOSARCOMA
LIPOSOMES|LIPOSOME
LIPOSUCTIONS|LIPOSUCTION
LIPOXYGENASES|LIPOXYGENASE
LIPREADINGS|LIPREADING
LIPS|LIP
LIQUID|BEVERAGE
LISTS|LIST
LITERACY|LITERACIES
LITERATURES|LITERATURE
LITHOLAPAXY|LITHOLAPAXIES
LITHOTRIPSY|LITHOTRIPSIES
LITIGATIONS|LITIGATION
LITORINE|LITORIN
LITTLES|LITTLE
LIVER|HEPATIC
LIVERS|HEPATIC
LIVES|LIFE
LIZARDS|LIZARD
LLAMAS|LLAMA
LOANS|LOAN
LOBBYINGS|LOBBYING
LOBES|LOBE
LOBOTOMY|LOBOTOMIES
LOBSTEINS|LOBSTEIN
LOBSTERS|LOBSTER
LOBULATION|LOBULATED
LOCALES|LOCALE
LOCALIZATIONS|LOCALIZATION
LOCATIONS|LOCATION
LOCOMOTIONS|LOCOMOTION
LOCUS|LOCI
LOCUSTS|LOCUST
LODGINGS|LODGING
LOGICS|LOGIC
LOIASIS|LOAIASIS
LONELINESSES|LONELINESS
LONGEVITY|LONGEVITIES
LONGSTANDING|CHRONIC
LOOPS|LOOP
LOOSENINGS|LOOSENING
LORCAINIDE|LORCAINID
LORDOSIS|LORDOSES
LORIS|LORI
LOROPHYNS|LOROPHYN
LORRS|LORR
LOSSES|LOSS
LOUSE|LICE
LOVES|LOVE
LOW|
DECREASE
LOWNESS|DECREASE
LOYALTY|LOYALTIES
LT|LEFT
LTRS|LTR
LUBRICATIONS|LUBRICATION
LUCERNES|LUCERNE
LUMBAGOS|LUMBAGO
LUMBAR|BACK
LUMICOLCHICINES|LUMICOLCHICINE
LUMINESCENCES|LUMINESCENCE
LUMPECTOMY|LUMPECTOMIES
LUNG|PULM
LUNGS|PULM
LUPULONE|LUPULON
LUTEAS|LUTEA
LUTEINOMAS|LUTEINOMA
LUTEMBACHERS|LUTEMBACHER
LUTEOMAS|LUTEOMA
LUTEOZYMAN|LUTEOZIMAN
LUTEUMS|LUTEUM
LUTZOMYIAS|LUTZOMYIA
LUXATIONS|LUXATION
LUXEMBOURG|LUXEMBORG
LUXEMBURG|LUXEMBORG
LYASES|LYASE
LYELLS|LYELL
LYINGS|LYING
LYMNAEAS|LYMNAEA
LYMNEA|LYMNAEA
LYMNEAS|LYMNAEA
LYMPHADENITIS|LYMPHADENITIDES
LYMPHADENOPATHY|LYMPHADENOPATHIES
LYMPHANGIECTASIA|LYMPHANGIECTASES
LYMPHANGIECTASIS|LYMPHANGIECTASES
LYMPHANGIOENDOTHELIOMAS|LYMPHANGIOENDOTHELIOMA
LYMPHANGIOGRAPHY|LYMPHANGIOGRAPHIES
LYMPHANGIOLEIOMYOMAS|LYMPHANGIOLEIOMYOMA
LYMPHANGIOMAS|LYMPHANGIOMA
LYMPHANGIOMYOMAS|LYMPHANGIOMYOMA
LYMPHANGIOSARCOMAS|LYMPHANGIOSARCOMA
LYMPHANGITIS|LYMPHANGITIDES
LYMPHAPHERESIS|LYMPHAPHERESES
LYMPHATIC|LYMPH
LYMPHEDEMAS|LYMPHEDEMA
LYMPHOCELES|LYMPHOCELE
LYMPHOCOELE|LYMPHOCELE
LYMPHOCOELES|LYMPHOCELE
LYMPHOCYTAPHERESIS|LYMPHOCYTAPHERESES
LYMPHOCYTE|LYMPHOCYT
LYMPHOCYTES|LYMPHOCYT
LYMPHOCYTIC|LYMPHOCYT
LYMPHOCYTOMAS|LYMPHOCYTOMA
LYMPHOCYTOPENIAS|LYMPHOCYTOPENIA
LYMPHOCYTOPHERESES|LYMPHOCYTAPHERESES
LYMPHOCYTOPHERESIS|LYMPHOCYTAPHERESES
LYMPHOCYTOSIS|LYMPHOCYTOSES
LYMPHOGRANULOMAS|LYMPHOGRANULOMA
LYMPHOGRAPHY|LYMPHOGRAPHIES
LYMPHOHISTIOCYTOSIS|LYMPHOHISTIOCYTOSES
LYMPHOKINES|LYMPHOKINE
LYMPHOMAS|LYMPHOMA
LYMPHOMATOSUMS|LYMPHOMATOSUM
LYMPHOPENIAS|LYMPHOPENIA
LYMPHOPHERESES|LYMPHAPHERESES
LYMPHOPHERESIS|LYMPHAPHERESES
LYMPHORETICULOSIS|LYMPHORETICULOSES
LYMPHOSARCOMAS|LYMPHOSARCOMA
LYMPHS|LYMPH
LYNESTRENOL|LINESTEROL
LYSINS|LYSIN
LYSOGENY|LYSOGENIES
LYSOLECITHINS|LYSOLECITHIN
LYSOPHOSPHATIDYLCHOLINES|LYSOPHOSPHATIDYLCHOLINE
LYSOPHOSPHATIDYLETHANOLAMINES|LYSOPHOSPHATIDYLETHANOLAMINE
LYSOPHOSPHATIDYLINOSITOLS|LYSOPHOSPHATIDYLINOSITOL
LYSOPHOSPHOLIPIDS|LYSOPHOSPHOLIPID
LYSOSOMES|LYSOSOME
LYSTHENON|LISTENON
LYSURID|LISURIDE
MACACAS|MACACA
MACAQUES|MACAQUE
MACAU|MACAO
MACHIAVELLIANISMS|MACHIAVELLIANISM
MACHINES|MACHINE
MACROECONOMIC|MACROECON
MACROFETOPROTEINS|MACROFETOPROTEIN
MACROGLOBULINEMIAS|MACROGLOBULINEMIA
MACROGLOBULINS|MACROGLOBULIN
MACROGLOSSIAS|MACROGLOSSIA
MACROGOLS|MACROGOL
MACROMOLECULAR|MACROMOL
MACROPHAGES|MACROPHAGE
MACROSOMIAS|MACROSOMIA
MACROSTOMIAS|MACROSTOMIA
MACTANS|MACTAN
MACULE|MACULAR
MACULES|MACULAR
MADELUNGS|MADELUNG
MADUROMYCOSIS|MADUROMYCOSES
MAEDUS|MAEDI
MAGAZINES|MAGAZINE
MAGICS|MAGIC
MAGNAS|MAGNA
MAGNETICS|MAGNETIC
MAGNETOENCEPHALOGRAPHY|MAGNETOENCEPHALOGRAPHIES
MAGNETOMETRY|MAGNETOMETRIES
MAGNIFICATIONS|MAGNIFICATION
MAGNUMS|MAGNUM
MAILS|MAIL
MAINSTREAMINGS|MAINSTREAMING
MAINTENANCES|MAINTENANCE
MAIZES|MAIZE
MAKINGS|MAKING
MALACIAS|MALACIA
MALACOPLAKIAS|MALACOPLAKIA
MALARIAS|MALARIA
MALATES|MALATE
MALEATES|MALEATE
MALEIMIDES|MALEIMIDE
MALES|MALE
MALFORMATIONS|MALFORMATION
MALFUNCTION|FAILURE
MALFUNCTIONS|FAILURE
MALIGNANCY|NEOPL
MALIGNANT|NEOPL
MALINGERINGS|MALINGERING
MALLOPHAGAS|MALLOPHAGA
MALNOURISHED|MALNUTR
MALNUTRITION|MALNUTR
MALNUTRITIONS|MALNUTR
MALOCCLUSIONS|MALOCCLUSION
MALONATES|MALONATE
MALTASES|MALTASE
MALTS|MALT
MAMILLARY|BREAST
MAMMALS|MAMMAL
MAMMARY|BREAST
MAMMOGRAPHY|MAMMOGRAPHIES
MAN|MALE
MANAGEMENT|ADMINISTRATOR
MANAGEMENTS|ADMINISTRATOR
MANAGER|ADMINISTRATOR
MANDIBLE|JAW
MANDIBLES|JAW
MANDRILLS|MANDRILL
MANEUVERS|MANEUVER
MANGES|MANGE
MANIAS|MANIA
MANIC|MANIA
MANIFESTATIONS|MANIFESTATION
MANIKINS|MANIKIN
MANIPULATIONS|MANIPULATION
MANNANS|MANNAN
MANNEQUIN|MANIKIN
MANNEQUINS|MANIKIN
MANNOS|MANNO
MANNOSEPHOSPHATES|MANNOSEPHOSPHATE
MANNOSIDASES|MANNOSIDASE
MANNOSIDES|MANNOSIDE
MANNOSIDOSIS|MANNOSIDOSES
MANNOSYLTRANSFERASES|MANNOSYLTRANSFERASE
MANOMETRY|MANOMETRIES
MANS|MALE
MANSONELLIASIS|MANSONELLIASES
MANSONII|MANSONI
MANSONUS|MANSONI
MANTIDS|MANTID
MANTIS|MANTI
MANUALS|MANUAL
MANUBRIUMS|MANUBRIUM
MANUFACTURES|MANUFACTURE
MANURES|MANURE
MANUSCRIPTS|MANUSCRIPT
MAPPINE|MAPPIN
MAPPINGS|MAPPING
MAPROTILINE|MAPROTILIN
MAPS|MAP
MAREKS|MAREK
MARES|MARE
MARFANS|MARFAN
MARGARINES|MARGARINE
MARIAHUANA|MARIHUANA
MARIAJUANA|MARIHUANA
MARIJUANA|MARIHUANA
MARKERS|MARKER
MARKETS|MARKET
MARKINGS|MARKING
MARKS|MARK
MARMOSETS|MARMOSET
MARMOTAS|MARMOTA
MARMOTS|MARMOT
MARRIAGES|MARRIAGE
MARRIEDS|MARRIED
MARSUPIALIAS|MARSUPIALIA
MARXISMS|MARXISM
MASKINGS|MASKING
MASKS|MASK
MASOCHISMS|MASOCHISM
MASSAGES|MASSAGE
MASSES|MASS
MASTECTOMY|MASTECTOMIES
MASTICATION|CHEWING
MASTICATIONS|CHEWING
MASTITIS|MASTITIDES
MASTOCYTOMAS|MASTOCYTOMA
MASTOCYTOSIS|MASTOCYTOSES
MASTOIDITIS|MASTOIDITIDES
MASTOIDS|MASTOID
MASTOPATHIES|MASTOPATHIA
MASTOPATHY|MASTOPATHIA
MASTURBATIONS|MASTURBATION
MATERIALS|MATERIAL
MATERS|MATER
MATHEMATICAL|MATHEMATIC
MATHEMATICS|MATHEMATIC
MATRIX|MATRICES
MATTING|MATTED
MATTRESSES|MATTRESSE
MATURATIONS|MATURATION
MATURITY|MATURITIES
MAXICIRCLES|MAXICIRCLE
MAXILLAS|MAXILLA
MAXIMS|MAXIM
MAXS|MAX
MAYERS|MAYER
MAZINDOLE|MAZINDOL
MCARDLES|MCARDLE
MEALS|MEAL
MEALWORMS|MEALWORM
MEANS|MEAN
MEASLES|MEASLE
MEASUREMENTS|MEASUREMENT
MEASURES|MEASURE
MEATS|MEAT
MEBHYDROLINE|MEBHYDROLIN
MECHANICS|MECHANIC
MECHANISMS|MECHANISM
MECHANORECEPTOR|MECHANORECEPT
MECHANORECEPTORS|MECHANORECEPT
MECKELS|MECKEL
MECONIUMS|MECONIUM
MEDAKAS|MEDAKA
MEDIAS|MEDIA
MEDIASTINITIS|MEDIASTINITIDES
MEDIASTINOSCOPY|MEDIASTINOSCOPIES
MEDIASTINUM|MEDIASTINAL
MEDIATORS|MEDIATOR
MEDICAGOS|MEDICAGO
MEDICAIDS|MEDICAID
MEDICAL|MED
MEDICARES|MEDICARE
MEDICATIONS|MEDICATION
MEDICES|MEDEX
MEDICINE|MED
MEDICINES|MED
MEDIUM|MEDIA
MEDULLAS|MEDULLA
MEDULLOBLASTOMAS|MEDULLOBLASTOMA
MEETINGS|MEETING
MEFENAMINIC|MEFENAMIC
MEGACINS|MEGACIN
MEGACOLONS|MEGACOLON
MEGAKARYOCYTES|MEGAKARYOCYTE
MEGAKARYOCYTOID|MEGAKARYOCYTIC
MEGALOBLASTS|MEGALOBLAST
MEGATHERIUM|MEGATERIUM
MEGOSINE|MEGOSIN
MEIGS|MEIG
MEIOSIS|MEIOSES
MEISSNERS|MEISSNER
MELANCHOLIAS|MELANCHOLIA
MELANINS|MELANIN
MELANOCYTES|MELANOCYTE
MELANOGASTERS|MELANOGASTER
MELANOGENS|MELANOGEN
MELANOMAS|MELANOMA
MELANOPHORES|MELANOPHORE
MELANOSIS|MELANOSES
MELANOSOMES|MELANOSOME
MELASMAS|MELASMA
MELENAS|MELENA
MELIOIDOSIS|MELIOIDOSES
MELITINE|MELITIN
MELITTIN|MELITTEN
MELKERSSON|MELKERSON
MELLERIL|MELLARIL
MELLERYL|MELLARIL
MELLITIN|MELITTEN
MELORHEOSTOSIS|MELORHEOSTOSES
MEMANTINE|MEMANTIN
MEMBERS|MEMBER
MEMBRANE|MEMB
MEMBRANES|MEMB
MEMORY|MEMORIES
MEN|MALE
MENARCHES|MENARCHE
MENIERES|MENIERE
MENINGES|MENINGE
MENINGIOMAS|MENINGIOMA
MENINGISMS|MENINGISM
MENINGITIS|MENINGITIDES
MENINGOCELES|MENINGOCELE
MENINGOCOCCIC|MENINGOCOCCAL
MENINGOCOCCUS|MENINGOCOCCAL
MENINGOENCEPHALITIS|MENINGOENCEPHALITIDES
MENINGOMYELOCELES|MENINGOMYELOCELE
MENISCUS|MENISCI
MENOPAUSE|MENOPAUSAL
MENOPAUSES|MENOPAUSAL
MENORRHAGIAS|MENORRHAGIA
MENOTROPINS|MENOTROPIN
MENSTRUATIONS|MENSTRUATION
MENTORS|MENTOR
MENTORSHIPS|MENTORSHIP
MEPHENAMINE|MEFENAMINE
MEPHENYTOIN|MEFENETOIN
MEPHLOQUINE|MEFLOQUINE
MERADINE|MERADIN
MERBROMINE|MERBROMIN
MERCAMINE|MERCAMIN
MERCAPTANS|MERCAPTAN
MERCAPTOETHYLAMINES|MERCAPTOETHYLAMINE
MERCAPTOMERINE|MERCAPTOMERIN
MERCAPTOPICOLINIC|MERCAPTOPICOLINATE
MERCAPTOPYRUVIC|MERCAPTOPYRUVATE
MERCAPTOQUINOLINE|MERCAPTOQUINOLINATE
MERCAZOLE|MERCAZOL
MERCAZOLYL|MERCASOLYL
MERCURIBENZOATES|MERCURIBENZOATE
MERCURIO|MERCURIC
MERCUROCHROME|MERCUROCHROM
MERCUROCROMO|MERCUROCHROM
MERCURY|MERCURIC
MERGERS|MERGER
MERIONES|MERIONE
MERKAZOLIL|MERCASOLYL
MEROMYOSINS|MEROMYOSIN
MERZBACHER|MERZABACHER
MESANGIUMS|MESANGIUM
MESENCEPHALONS|MESENCEPHALON
MESENCEPHALUS|MESENCEPHALI
MESENCHYMOMAS|MESENCHYMOMA
MESENTERIES|MESENTERIC
MESENTERY|MESENTERIC
MESHES|MESH
MESHWORKS|MESHWORK
MESMERISMS|MESMERISM
MESNUM|MESNA
MESOCOLONS|MESOCOLON
MESODERMS|MESODERM
MESONEPHROMAS|MESONEPHROMA
MESONEPHROS|MESONEPHRO
MESONS|MESON
MESOPORPHYRINS|MESOPORPHYRIN
MESOSIGMOIDS|MESOSIGMOID
MESOTHELIOMAS|MESOTHELIOMA
MESOZOAS|MESOZOA
MESSENGERS|MESSENGER
MESTERONE|MESTERON
MESYLATE|MESILATE
METABOL|METAB
METABOLIC|METAB
METABOLICS|METAB
METABOLISM|METAB
METABOLISMS|METAB
METABOLITE|METAB
METACLOPROMIDE|METACLOPRAMIDE
METAETHICS|METAETHIC
METAGONIMIASIS|METAGONIMIASES
METALLIC|METAL
METALLOENDOPEPTIDASES|METALLOENDOPEPTIDASE
METALLOPROTEINASES|METALLOPROTEINASE
METALLURGY|METALLURGIES
METALS|METAL
METAMIZOLE|METAMIZOL
METAMORPHOSIS|METAMORPHOSES
METAPHASES|METAPHASE
METAPHYSICS|METAPHYSIC
METAPLASIAS|METAPLASIA
METAPROTERNAL|METAPROTERENOL
METARHODOPSINS|METARHODOPSIN
METASTASES|SECOND
METASTASIS|SECOND
METATARSALS|METATARSAL
METENCEPHALONS|METENCEPHALON
METEOROLOGICAL|METEOROLOGIC
METEOROLOGY|METEOROLOGIES
METERS|METER
METHACIN|METACIN
METHACRYLATES|METHACRYLATE
METHAMIZOLE|METAMIZOL
METHANESULFONATES|METHANESULFONATE
METHANOGENS|METHAGENS
METHANOL|ALCOHOL
METHEMOGLOBINEMIAS|METHEMOGLOBINEMIA
METHIOTHEPINE|METHIOTHEPIN
METHODOLOGY|METHODOLOGIES
METHODS|METHOD
METHOXYCINNAMIC|METHOXYCINNAMATE
METHOXYDIMETHYLTRYPTAMINES|METHOXYDIMETHYLTRYPTAMINE
METHYLADIPIC|METHYLADIPATE
METHYLAMINES|METHYLAMINE
METHYLASES|METHYLASE
METHYLATIONS|METHYLATION
METHYLCITRIC|METHYLCITRATE
METHYLCOBALAMINE|METHYLCOBALAMIN
METHYLENEDISALICYLIC|METHYLENEDISALICYLATE
METHYLGALLIC|METHYLGALLATE
METHYLGLUCOSIDES|METHYLGLUCOSIDE
METHYLGLUTAMIC|METHYLGLUTAMATE
METHYLHISTAMINES|METHYLHISTAMINE
METHYLHISTIDINES|METHYLHISTIDINE
METHYLHYDRAZINES|METHYLHYDRAZINE
METHYLMALONIC|METHYLMALONATE
METHYLMANNOPYRANOSIDES|METHYLMANNOPYRANOSIDE
METHYLMANNOSIDES|METHYLMANNOSIDE
METHYLMERCURY|METHYLMERCURIC
METHYLMETHACRYLATES|METHYLMETHACRYLATE
METHYLOMONADACEAE|METHYLMONADACEAE
METHYLPHOSPHONATES|METHYLPHOSPHONATE
METHYLTETRAHYDROHOMOFOLIC|METHYLTETRAHYDROHOMOFOLATE
METHYLTRANSFERASES|METHYLTRANSFERASE
METHYLTYROSINES|METHYLTYROSINE
METHYLVALERIC|METHYLVALERATE
METHYMAZOL|METHIMAZOLE
METHYPRYLON|METHPRYLON
METHYSOPRINOL|METHISOPRINOL
METISAZONE|METHISAZONE
METISOPRINOL|METHISOPRINOL
METITEPINE|METHIOTHEPIN
METOCLOPRAMIDE|METACLOPRAMIDE
METOPIRONE|METOPIRON
METRORRHAGIAS|METRORRHAGIA
MEXICANUMS|MEXICANUM
MEXICO|MEXICAN
MEXITYL|MEXITIL
MEZLOCILLIN|MESLOCILLIN
MEZLOCILLINE|MESLOCILLIN
MICELLES|MICELLE
MICROANALYSES|MICROANAL
MICROANALYSIS|MICROANAL
MICROANGIOPATHY|MICROANGIOPATHIES
MICROBIOLOGIC|MICROBIOL
MICROBIOLOGICAL|MICROBIOL
MICROBIOLOGIES|MICROBIOL
MICROBIOLOGY|MICROBIOL
MICROBODY|MICROBODIES
MICROCEPHALIES|MICROCEPHALIC
MICROCEPHALUS|MICROCEPHALIC
MICROCEPHALY|MICROCEPHALIC
MICROCHEMISTRIES|MICROCHEM
MICROCHEMISTRY|MICROCHEM
MICROCINS|MICROCIN
MICROCIRCULATIONS|MICROCIRCULATION
MICROCLIMATES|MICROCLIMATE
MICROCOCCUS|MICROCOCCAL
MICROCOMPUTER|COMPUTED
MICROCOMPUTERS|COMPUTED
MICROECONOMIC|MICROECON
MICROELECTRODES|MICROELECTRODE
MICROENCAPSULATIONS|MICROENCAPSULATION
MICROFILAMENTS|MICROFILAMENT
MICROFILMINGS|MICROFILMING
MICROFLUORIMETRY|MICROFLUORIMETRIES
MICROFLUOROMETRY|MICROFLUOROMETRIES
MICROGLOSSIAS|MICROGLOSSIA
MICROGNATHISM|MICROGNATHIA
MICROGNATHISMS|MICROGNATHIA
MICROINJECTION|MICROINJECT
MICROINJECTIONS|MICROINJECT
MICROINTERFEROMETRY|MICROINTERFEROMETRIES
MICROMANIPULATIONS|MICROMANIPULATION
MICRONAZOLE|MICONASIL
MICRONEPHRINE|MICRONEFRIN
MICRONUCLEUS|MICRONUCLEI
MICROORGANISM|VIRAL
MICROPHTHALMOS|MICROPHTHALMIA
MICROPROCESSORS|MICROPROCESSOR
MICRORADIOGRAPHY|MICRORADIOGR
MICROSCOPY|MICROSCOPIES
MICROSOMES|MICROSOME
MICROSOMIAS|MICROSOMIA
MICROSPECTROPHOTOMETRY|MICROSPECTROPHOTOMETRIES
MICROSPHERES|MICROSPHERE
MICROSTOMIAS|MICROSTOMIA
MICROSURGERIES|MICROSURG
MICROSURGERY|MICROSURG
MICROSURGICAL|MICROSURG
MICROTINES|MICROTINE
MICROTOMY|MICROTOMIES
MICROTUBULES|MICROTUBULE
MICROVILLUS|MICROVILLI
MICROWAVES|MICROWAVE
MIDBRAINS|
MIDBRAIN
MIDEPIGASTRIC|EPIGASTRIC
MIDGES|MIDGE
MIDMENSTRUATIONS|MIDMENSTRUATION
MIDODRINE|MIDODRIN
MIDTRIMESTERS|MIDTRIMESTER
MIDWESTERN|MIDWEST
MIDWIFERY|MIDWIFERIES
MIDWIVE|MIDWIFES
MIDWIVES|MIDWIFES
MIGRAINES|MIGRAINE
MIGRANTS|MIGRANT
MIGRATIONS|MIGRATION
MIGRATORY|MIGRATING
MIKAMYCINS|MIKAMYCIN
MILBEMYCINS|MILBEMYCIN
MILIARIAS|MILIARIA
MILITARY|ARMY
MILKERS|MILKER
MILKS|MILK
MILLETS|MILLET
MILROYS|MILROY
MILURITE|MILURIT
MIMOCINE|MIMOCIN
MINERALOCORTICOIDS|MINERALOCORTICOID
MINERALS|MINERAL
MINERS|MINER
MINIATURIZATIONS|MINIATURIZATION
MINIBIKES|MINIBIKE
MINICOMPUTER|COMPUTED
MINICOMPUTERS|COMPUTED
MINILAPAROTOMY|MINILAPAROTOMIES
MININGS|MINING
MINIPIGS|MINIPIG
MINKS|MINK
MINNOWS|MINNOW
MINORS|MINOR
MINTEZOL|MINTESOL
MINUTES|MINUTE
MIOSIS|MIOSES
MISARTICULATIONS|MISARTICULATION
MISCARRIAGE|ABORTION
MISCARRIAGES|ABORTION
MISCONDUCTS|MISCONDUCT
MISKLERON|MISCLERON
MISSCARRIED|ABORTED
MISSIONARY|MISSIONARIES
MISSIONS|MISSION
MIST|AEROSOL
MISTAKE|ERR
MISUSE|ABUSE
MISUSES|ABUSE
MITES|MITE
MITOCHONDRIAS|MITOCHONDRIA
MITOGENS|MITOGEN
MITOMYCINS|MITOMYCIN
MITOSIS|MITOSES
MITOZANTRONE|MITOXANTRONE
MIXEDS|MIXED
MIXES|MIX
MIXTURES|MIXTURE
MOBILITY|MOBILITIES
MOBILIZATIONS|MOBILIZATION
MODELINGS|MODELING
MODELS|MODEL
MODIFICATION|ADJUSTMENT
MODIFICATIONS|ADJUSTMENT
MODIFIERS|MODIFIER
MODULATOR|MODULATING
MOHAMMEDANISMS|MOHAMMEDANISM
MOHS|MOH
MOLARS|MOLAR
MOLASSES|MOLASSE
MOLDS|MOLD
MOLECULAR|MOLEC
MOLECULES|MOLECULE
MOLES|MOLE
MOLESTATIONS|MOLESTATION
MOLLUSK|MOLLUSC
MOLLY|MOLLIES
MOLSIDOMINE|MOLSIDOMIN
MONGOLISMS|MONGOLISM
MONGOOSES|MONGOOSE
MONIEZIASIS|MONIEZIASES
MONILIASIS|MONILIASES
MONITORINGS|MONITORING
MONITORS|MONITOR
MONKEY|MONKEIES
MONKEYS|MONKEIES
MONOACYLGLYCEROLS|MONOACYLGLYCEROL
MONOAMINES|MONOAMINE
MONOBACTAMS|MONOBACTAM
MONOCYTES|MONOCYTE
MONOGLYCERIDES|MONOGLYCERIDE
MONOGRAPH|MONOGR
MONONUCLEOSIS|MONONUCLEOSES
MONOOXYGENASES|MONOOXYGENASE
MONOPHOSPHATES|MONOPHOSPHATE
MONOSACCHARIDES|MONOSACCHARIDE
MONOSOMY|MONOSOMIES
MONOSPOT|HETEROPHIL
MONOTREMATAS|MONOTREMATA
MONSTERS|MONSTER
MONTEGGIAS|MONTEGGIA
MONTHS|MONTH
MONTMORRILLONITE|MONTMORILLONITE
MOOD|AFFECT
MOODS|AFFECT
MOONS|MOON
MOPEDS|MOPED
MORACIZINE|MORACIZIN
MORALE|MORAL
MORALES|MORAL
MORALITY|MORALITIES
MORALS|MORAL
MORBIDITY|MORBIDITIES
MORICIZINE|MORACIZIN
MORMYRIDS|MORMYRID
MORPHEAS|MORPHEA
MORPHOGENESIS|MORPHOGENESES
MORPHOLINES|MORPHOLINE
MORTALITIES|MORTAL
MORTALITY|MORTAL
MORTIS|MORTI
MORULAS|MORULA
MOSQUITOE|MOSQUITO
MOSQUITOES|MOSQUITO
MOTHERS|MOTHER
MOTHS|MOTH
MOTILITY|MOTILITIES
MOTIONS|MOTION
MOTIVATIONS|MOTIVATION
MOTOR|EFFERENT
MOTORBIKES|MOTORBIKE
MOTORCYCLES|MOTORCYCLE
MOTTLING|MOTTLED
MOULAGES|MOULAGE
MOUNTAINEERINGS|MOUNTAINEERING
MOUSE|MICE
MOUTHPIECES|MOUTHPIECE
MOUTHS|MOUTH
MOUTHWASHES|MOUTHWASHE
MOVEMENTS|MOVEMENT
MOVINGS|MOVING
MOXIBUSTIONS|MOXIBUSTION
MUCILAGES|MUCILAGE
MUCINOSAS|MUCINOSA
MUCINS|MUCIN
MUCOCELES|MUCOCELE
MUCOCUTANEOUS|MUCOCUTAN
MUCOLIPIDOSIS|MUCOLIPIDOSES
MUCOPEPTIDES|MUCOPEPTIDE
MUCOPOLYSACCHARIDES|MUCOPOLYSACCHARIDE
MUCOPOLYSACCHARIDOSIS|MUCOPOLYSACCHARIDOSES
MUCOPROTEINS|MUCOPROTEIN
MUCORMYCOSIS|MUCORMYCOSES
MUCOSAL|MUCOSA
MUCOSAS|MUCOSA
MUCOVISCIDOSIS|MUCOVISCIDOSES
MUCUS|MUCU
MUDMINNOWS|MUDMINNOW
MUDPUPPY|MUDPUPPIES
MULATTAS|MULATTA
MULLETS|MULLET
MULTICENTRE|MULTICENTER
MULTIFOCAL|MULTIFOC
MULTIFORMES|MULTIFORME
MULTIHOSPITAL|MULTIHOSP
MULTIPARITY|MULTIPARITIES
MUMMY|MUMMIES
MUMPS|MUMP
MUNCHHAUSEN|MUNCHAUSEN
MUONS|MUON
MURDERS|MURDER
MURIDS|MURID
MURMURS|MURMUR
MUSCLE|MUSCL
MUSCLES|MUSCL
MUSCULAR|MUSCL
MUSEUMS|MUSEUM
MUSHROOMS|MUSHROOM
MUSICS|MUSIC
MUSKRATS|MUSKRAT
MUSLIMS|MUSLIM
MUSSELS|MUSSEL
MUSTARDS|MUSTARD
MUTAGENESIS|MUTAGENESES
MUTAGENS|MUTAGEN
MUTANS|MUTAN
MUTANTS|MUTANT
MUTATIONS|MUTATION
MUTILATIONS|MUTILATION
MUTISMS|MUTISM
MYALGIAS|MYALGIA
MYAMBUTOL|MIAMBUTOL
MYASTHENIC|MYASTHENIA
MYCETOMAS|MYCETOMA
MYCINAMICINS|MYCINAMICIN
MYCOBACTERIOPHAGES|MYCOBACTERIOPHAGE
MYCOBACTERIUM|MYCOBACTERIAL
MYCOBACTINS|MYCOBACTIN
MYCOLOGY|MYCOLOGIES
MYCOSIS|MYCOSES
MYCOSUBTILINE|MYCOSUBTILIN
MYCOTOXICOSIS|MYCOTOXICOSES
MYCOTOXINS|MYCOTOXIN
MYDOCALM|MIDOCALM
MYELENCEPHALONS|MYELENCEPHALON
MYELITIS|MYELITIDES
MYELOCELES|MYELOCELE
MYELODYSPLASIAS|MYELODYSPLASIA
MYELOFIBROSIS|MYELOFIBROSES
MYELOGENOUS|MYELOCYTIC
MYELOGRAPHY|MYELOGRAPHIES
MYELOMAS|MYELOMA
MYELOMATA|MYELOMA
MYELOMENINGOCELES|MYELOMENINGOCELE
MYELOPATHY|MYELOPATHIES
MYELOSCLEROSIS|MYELOSCLEROSES
MYELOSIS|MYELOSES
MYIASIS|MYIASES
MYOBLASTOMAS|MYOBLASTOMA
MYOCAMICIN|MIOCAMYCIN
MYOCARDIAL|CARDIAC
MYOCARDIOPATHY|MYOCARDIOPATHIES
MYOCARDITIS|MYOCARDITIDES
MYOCARDIUM|CARDIAC
MYOCARDIUMS|CARDIAC
MYOCLONUS|MYOCLONIC
MYOCRISIN|MYCORISIN
MYOCRYSINE|MYCORISIN
MYODIL|MAIODIL
MYOEPITHELIOMAS|MYOEPITHELIOMA
MYOFIBRILS|MYOFIBRIL
MYOFILAMENTS|MYOFILAMENT
MYOGLOBINURIAS|MYOGLOBINURIA
MYOGRAPHY|MYOGRAPHIES
MYOKYMIAS|MYOKYMIA
MYOMAS|MYOMA
MYOMETRIUMS|MYOMETRIUM
MYOPATHY|MYOPATHIES
MYOPIAS|MYOPIA
MYOSARCOMAS|MYOSARCOMA
MYOSIS|MIOSES
MYOSITIS|MYOSITIDES
MYOTONIAS|MYOTONIA
MYOTONICA|MYOTONIC
MYRINGOPLASTY|MYRINGOPLASTIES
MYRISTATES|MYRISTATE
MYSTICISMS|MYSTICISM
MYTHOLOGY|MYTHOLOGIES
MYTOTAN|MITOTANE
MYXEDEMAS|MYXEDEMA
MYXOMAS|MYXOMA
MYXOMATOSIS|MYXOMATOSES
MYXOSARCOMAS|MYXOSARCOMA
MYXOVIRUSES|MYXOVIRUS
NADP|NAD
NADPH|NAD
NAFTIFINE|NAFTIFIN
NAGANAS|NAGANA
NAILINGS|NAILING
NAILS|NAIL
NAJJAR|NAJAR
NAMES|NAME
NAPHTHALENES|NAPHTHALENE
NAPHTHALENESULFONATES|NAPHTHALENESULFONATE
NAPHTHOLS|NAPHTHOL
NAPHTHOQUINONES|NAPHTHOQUINONE
NAPHTHYLAMIDASES|NAPHTHYLAMIDASE
NAPHTHYRIDINES|NAPHTHYRIDINE
NAPS|NAP
NARCINES|NARCINE
NARCISSISMS|NARCISSISM
NARCOLEPSY|NARCOLEPSIES
NARCOSIS|NARCOSES
NARCOSYNTHESES|NARCOSYN
NARCOSYNTHESIS|NARCOSYN
NARCOTHERAPIES|NARCOTHER
NARCOTHERAPY|NARCOTHER
NARCOTICS|NARCOTIC
NASALES|NASAL
NASMYTHS|NASMYTH
NASOPHARYNGITIS|NASOPHARYNGITIDES
NASOPHARYNXES|NASOPHARYNX
NATIONALITY|NATIONALITIES
NATL|NATIONAL
NATRIURESIS|NATRIURESES
NATUROPATHY|NATUROPATHIES
NAUSEAS|NAUSEA
NAUSEATED|NAUSEA
NCFPS|NCFP
NEBULIZERS|NEBULIZER
NECATORIASIS|NECATORIASES
NECKS|NECK
NECROBACILLOSIS|NECROBACILLOSES
NECROLYSIS|NECROLYSES
NECROSIS|NECROSES
NECROTIC|NECROSES
NECROTIZING|
NECRO
NEEDLES|NEEDLE
NEEDS|NEED
NEGATIVE|NEG
NEGATIVISMS|NEGATIVISM
NEGATRONS|NEGATRON
NEGLECTS|NEGLECT
NEGROES|NEGRO
NEIGHBORHOODS|NEIGHBORHOOD
NEMATODES|NEMATODE
NEMESTRINAS|NEMESTRINA
NEONATES|NEONATE
NEONATOLOGY|NEONATOLOGIES
NEONATORUMS|NEONATORUM
NEOPLASM|NEOPL
NEOPLASMS|NEOPL
NEOPLASTIC|NEOPL
NEOPLS|NEOPL
NEOTHRAMYCINS|NEOTHRAMYCIN
NEOTOMAS|NEOTOMA
NEOVASCULARIZATION|NEOVASCULAR
NEOVASCULARIZATIONS|NEOVASCULAR
NEPHRECTOMY|NEPHRECTOMIES
NEPHRITIS|NEPHRITIDES
NEPHROBLASTOMAS|NEPHROBLASTOMA
NEPHROCALCINOSIS|NEPHROCALCINOSES
NEPHROLOGY|NEPHROLOGIES
NEPHRONS|NEPHRON
NEPHROPATHY|NEPHROPATHIES
NEPHROSCLEROSIS|NEPHROSCLEROSES
NEPHROSIS|NEPHROSES
NEPHROSTOMY|NEPHROSTOMIES
NERVES|NERVE
NERVORUMS|NERVORUM
NERVOSAS|NERVOSA
NERVOUSNESSES|NERVOUSNESS
NESIDIOBLASTOMAS|NESIDIOBLASTOMA
NESIDIOBLASTOSIS|NESIDIOBLASTOSES
NESIDIOBLASTS|NESIDIOBLAST
NETS|NET
NETWORKS|NETWORK
NEULEPTYL|NEULEPTIL
NEURALGIAS|NEURALGIA
NEURANATOMY|NEURANAT
NEURASTHENIAS|NEURASTHENIA
NEURILEMMAS|NEURILEMMA
NEURILEMMOMAS|NEURILEMMOMA
NEURILEMOMA|NEURILEMMOMA
NEURILEMOMAS|NEURILEMMOMA
NEURITIS|NEURITIDES
NEUROANAT|NEURANAT
NEUROANATOMY|NEURANAT
NEUROBIOLOGY|NEUROBIOLOGIES
NEUROBLASTOMAS|NEUROBLASTOMA
NEUROCHEMISTRIES|NEUROCHEM
NEUROCHEMISTRY|NEUROCHEM
NEURODERMATITIS|NEURODERMATITIDES
NEUROENDOCRINOLOGY|NEUROENDOCRINOLOGIES
NEUROEPITHELIOMAS|NEUROEPITHELIOMA
NEUROFIBRILS|NEUROFIBRIL
NEUROFIBROMAS|NEUROFIBROMA
NEUROFIBROMATOSIS|NEUROFIBROMATOSES
NEUROFILAMENTS|NEUROFILAMENT
NEUROGLIAS|NEUROGLIA
NEUROHUMORS|NEUROHUMOR
NEUROHYPOPHYSIS|NEUROHYPOPHYSES
NEUROIMMUNOMODULATION|NEUROIMMUNOMOD
NEUROIMMUNOMODULATIONS|NEUROIMMUNOMOD
NEUROLEPTANALGESIAS|NEUROLEPTANALGESIA
NEUROLEPTIC|ANTIPSYCHOTIC
NEUROLEPTICS|ANTIPSYCHOTIC
NEUROLEPTOANALGESIA|NEUROLEPTANALGESIA
NEUROLEPTOANALGESIAS|NEUROLEPTANALGESIA
NEUROLOGIC|NEUROLGIC
NEUROLOGICAL|NEUROLGIC
NEUROLYMPHOMATOSIS|NEUROLYMPHOMATOSES
NEUROMAS|NEUROMA
NEUROMODULATORS|NEUROMODULATOR
NEURONS|NEURON
NEUROPATHY|NEUROPATHIES
NEUROPEPTIDES|NEUROPEPTIDE
NEUROPHARMACOLOGY|NEUROPHARMACOL
NEUROPHYSINS|NEUROPHYSIN
NEUROPHYSIOLOGY|NEUROPHYSIOL
NEUROPSYCHOLOGIC|NEUROPSYCHOL
NEUROPSYCHOLOGICAL|NEUROPSYCHOL
NEUROPSYCHOLOGY|NEUROPSYCHOL
NEURORADIOGRAPHY|NEURORADIOGR
NEURORECEPTOR|NEURORECEPT
NEURORECEPTORS|NEURORECEPT
NEUROREGULATORS|NEUROREGULATOR
NEUROSCIENCES|NEUROSCIENCE
NEUROSECRETION|NEUROSECRET
NEUROSECRETIONS|NEUROSECRET
NEUROSECRETORY|NEUROSECRET
NEUROSES|NEUROSE
NEUROSIS|NEUROSE
NEUROSURGERY|NEUROSURG
NEUROSYPHILIS|NEUROSYPHILI
NEUROTIZATIONS|NEUROTIZATION
NEUROTOXINS|NEUROTOXIN
NEUROTRANSMITTER|NEUROTRANSM
NEUROTRANSMITTERS|NEUROTRANSM
NEUTRONS|NEUTRON
NEUTROPENIAS|NEUTROPENIA
NEUTROPENIC|NEUTROPENIA
NEUTROPHILIC|NEUTROPHIL
NEUTROPHILS|NEUTROPHIL
NEVOXANTHOENDOTHELIOMAS|NEVOXANTHOENDOTHELIOMA
NEWBORNS|NEWBORN
NEWS|NEW
NEWSLETTERS|NEWSLETTER
NEWSPAPERS|NEWSPAPER
NEWTS|NEWT
NHPICS|NHPIC
NICARBAZINE|NICARBAZIN
NICOTINIC|NICOTINATE
NICOTINYL|NICOTINATE
NIDATIONS|NIDATION
NIDDMS|NIDDM
NIFUROXIME|NIFUROXIM
NIGHTMARES|NIGHTMARE
NIGRAS|NIGRA
NIGRICANS|NIGRICAN
NIKETHAMIDE|NICETHAMIDE
NILUDIPINE|NILUDIPIN
NINETEEN|19
NINTY|90
NIPPLES|NIPPLE
NISONE|NISON
NITRATES|NITRATE
NITREFAZOLE|NITREFAZOL
NITRILES|NITRILE
NITRITES|NITRITE
NITROBENZENES|NITROBENZENE
NITROBENZOATES|NITROBENZOATE
NITROIMIDAZOLE|NITROIMIDAZOL
NITROIMIDAZOLES|NITROIMIDAZOL
NITROMIPHENE|NITROMIFENE
NITRONES|NITRON
NITROPHENOLS|NITROPHENOL
NITROPHENYLGALACTOSIDES|NITROPHENYLGALACTOSIDE
NITROPROPIONIC|NITROPROPIONATE
NITROQUINOLINES|NITROQUINOLINE
NITROREDUCTASES|NITROREDUCTASE
NITROSAMINES|NITROSAMINE
NITROSATIONS|NITROSATION
NITROSOGUANIDINES|NITROSOGUANIDINE
NITROSOURETHANE|NITROSOURETHAN
NITROXYNIL|NITROXINIL
NITROXYSTEARIC|NITROXYSTEARATE
NIVALINE|NIVALIN
NOCICEPTORS|NOCICEPTOR
NODES|NODE
NODOSUMS|NODOSUM
NODULES|NODULE
NOISES|NOISE
NOMADS|NOMAD
NOMAS|NOMA
NOMENCLATURES|NOMENCLATURE
NOMIFENSINE|NOMIFENSIN
NONACHLAZINE|NONACHLAZIN
NONAGENARIANS|
NONAGENARIAN
NONAKHLAZIN|NONACHLAZIN
NONCHEMICAL|NONCHEM
NONDISJUNCTIONS|NONDISJUNCTION
NONHODGKINS|NONHODGKIN
NONMEDICAL|NONMED
NONMIGRANTS|NONMIGRANT
NONPRODUCTIVE|DRY
NOONANS|NOONAN
NOOTROPYL|NOOTROPIL
NORACYCLINE|NORACYCLIN
NORCOLUTE|NORCOLUT
NORFLUOXETINE|NORFLUOXETIN
NORFLURAZONE|NORFLURAZON
NORMOBLASTS|NORMOBLAST
NORPROGESTERONES|NORPROGESTERONE
NORTHERN|NORTH
NOSES|NOSE
NOTIFICATIONS|NOTIFICATION
NOTOCHORDS|NOTOCHORD
NOVOCAINAMIDE|NOVOCAINAMID
NOVOCAMIDE|NOVOCAMID
NTG|NITROGLYCERIN
NUCLEAR|ATOMIC
NUCLEASES|NUCLEASE
NUCLEOLYSIS|NUCLEOLYSES
NUCLEOPROTEINS|NUCLEOPROTEIN
NUCLEOSIDASES|NUCLEOSIDASE
NUCLEOSIDES|NUCLEOSIDE
NUCLEOSOMES|NUCLEOSOME
NUCLEOTIDASES|NUCLEOTIDASE
NUCLEOTIDES|NUCLEOTIDE
NUCLEOTIDYLTRANSFERASES|NUCLEOTIDYLTRANSFERASE
NUCLEUS|NUCLEI
NUDISMS|NUDISM
NULLIPARITY|NULLIPARITIES
NUMBERS|NUMBER
NUMISMATICS|NUMISMATIC
NUPERCAINE|NUPERCAINAL
NURSE|NURS
NURSERY|NURSERIES
NURSES|NURS
NURSING|NURS
NURSINGS|NURS
NUTRITIONS|NUTRITION
NUTS|NUT
NYCETIBUS|NYCETIBU
NYCTIPHANES|NYCTIPHANE
NYLONS|NYLON
NYMPHS|NYMPH
NYSTAGMUS|NYSTAGMU
OATHS|OATH
OATS|OAT
OBESE|OBESITIES
OBESITY|OBESITIES
OBIDOXIME|OBIDOXIM
OBJECTIVES|OBJECTIVE
OBLIGATIONS|OBLIGATION
OBLITERANS|OBLITERAN
OBLONGATAS|OBLONGATA
OBSILAZINE|OBSILAZIN
OBSTETRIC|OBSTET
OBSTETRICAL|OBSTET
OBSTETRICS|OBSTET
OBSTRUCT|OBSTR
OBSTRUCTED|OBSTR
OBSTRUCTION|OBSTR
OBSTRUCTIONS|OBSTR
OBSTRUCTIVE|OBSTR
OBTURATIONS|OBTURATION
OBTURATORS|OBTURATOR
OBZIDAN|OBSIDAN
OCCLUSIONS|OCCLUSION
OCCULTA|OCCULT
OCCULTISMS|OCCULTISM
OCCUPANCY|OCCUPANCIES
OCCUPATIONAL|OCCUP
OCCUPATIONS|OCCUPATION
OCEAN|MARINE
OCEANOGRAPHY|OCEANOGRAPHIES
OCEANS|MARINE
OCHRATOXINS|OCHRATOXIN
OCHRONOSIS|OCHRONOSES
OCTABENZOIC|OCTABENZOATE
OCTADECENOIC|OCTADECENOATE
OCTANES|OCTANE
OCTANESULFONIC|OCTANESULFONATE
OCTANOATES|OCTANOATE
OCTANOLS|
OCTANOL
OCTODONS|OCTODON
OCTOGENARIANS|OCTOGENARIAN
OCTOPRESSIN|OCTAPRESSIN
OCULAR|EYE
OCULOMYCOSIS|OCULOMYCOSES
OCULUS|OCULI
ODDIS|ODDI
ODONTOBLASTS|ODONTOBLAST
ODONTOCLASTS|ODONTOCLAST
ODONTOGENESIS|ODONTOGENESES
ODONTOMAS|ODONTOMA
ODONTOMETRY|ODONTOMETRIES
ODORS|ODOR
OESOPHAGOSTOMIASIS|OESOPHAGOSTOMIASES
OFFENSES|OFFENSE
OFFICES|OFFICE
OFLOXACINE|OFLOXACIN
OGILVIES|OGILVIE
OILS|OIL
OILY|OBESITIES
OINTMENTS|OINTMENT
OKTADIN|OCTADINE
OLD|
GERIATRIC
OLEFINS|OLEFIN
OLFACTIONS|OLFACTION
OLIGOCHAETAS|OLIGOCHAETA
OLIGODENDROCYTES|OLIGODENDROCYTE
OLIGODENDROGLIAS|OLIGODENDROGLIA
OLIGODENDROGLIOMAS|OLIGODENDROGLIOMA
OLIGODENDROMAS|OLIGODENDROMA
OLIGODEOXYRIBONUCLEOTIDES|OLIGODEOXYRIBONUCLEOTIDE
OLIGOMANNOSIDES|OLIGOMANNOSIDE
OLIGOMENORRHEAS|OLIGOMENORRHEA
OLIGOMYCINS|OLIGOMYCIN
OLIGONUCLEOTIDES|OLIGONUCLEOTIDE
OLIGOPEPTIDES|OLIGOPEPTIDE
OLIGOPHRENIAS|OLIGOPHRENIA
OLIGORIBONUCLEOTIDES|OLIGORIBONUCLEOTIDE
OLIGOSACCHARIDES|OLIGOSACCHARIDE
OLIGOSPERMIAS|OLIGOSPERMIA
OLIGURIAS|OLIGURIA
OLIVOMYCINS|OLIVOMYCIN
OLLIERS|OLLIER
OMASUMS|OMASUM
OMBUDSMENS|OMBUDSMEN
OMENTUMS|OMENTUM
OMPHALOCELES|OMPHALOCELE
ONCHOCERCIASIS|ONCHOCERCIASES
ONCOGENES|ONCOGENE
ONCOLOGICAL|ONCOLOGIC
ONCOLOGY|ONCOLOGIES
ONCOPROTEINS|ONCOPROTEIN
ONCORNAVIRUSES|ONCORNAVIRUS
ONCOVINE|ONCOVIN
ONCOVIRUSES|ONCOVIRUS
ONDATRAS|ONDATRA
ONDINES|ONDINE
ONE|1
ONIONS|ONION
ONLAYS|ONLAY
ONSETS|ONSET
ONYCHODYSPLASIAS|ONYCHODYSPLASIA
ONYCHOMYCOSIS|ONYCHOMYCOSES
OOCYTES|OOCYTE
OOGENESIS|OOGENESES
OOPHORECTOMY|OOPHORECTOMIES
OOPHORITIS|OOPHORITIDES
OPACITY|OPACITIES
OPACITYS|OPACITIES
OPENED|OPEN
OPERATIONAL|OPERATION
OPERATIONS|OPERATION
OPERATORS|OPERATOR
OPERONS|OPERON
OPHTHALMIAS|OPHTHALMIA
OPHTHALMIC|EYE
OPHTHALMODYNAMOMETRY|OPHTHALMODYNAMOMETRIES
OPHTHALMOPLEGIAS|OPHTHALMOPLEGIA
OPHTHALMOSCOPY|OPHTHALMOSCOPIES
OPIATES|OPIATE
OPINION|ATTITUDE
OPINIONS|ATTITUDE
OPIOIDS|OPIOID
OPISTHORCHIASIS|OPISTHORCHIASES
OPOSSUMS|OPOSSUM
OPPENHEIMS|OPPENHEIM
OPSONINS|OPSONIN
OPTIC|EYE
OPTICAS|OPTICA
OPTICS|EYE
OPTOMETRY|OPTOMETRIES
ORAL|MOUTH
ORANGUTANS|ORANGUTAN
ORAZAMIDE|ORAZAMID
ORBITAL|ORBIT
ORBITS|ORBIT
ORCHIDECTOMY|ORCHIDECTOMIES
ORCHIECTOMY|ORCHIECTOMIES
ORCHITIS|ORCHITIDES
ORDERS|ORDER
ORGANELLES|ORGANELLE
ORGANIC|HOLISTIC
ORGANISMS|ORGANISM
ORGANIZATION|ORGANISATION
ORGANIZATIONS|ORGANISATION
ORGANIZERS|ORGANIZER
ORGANOIDS|ORGANOID
ORGANOTHERAPIES|ORGANOTHER
ORGANOTHERAPY|ORGANOTHER
ORGANS|ORGAN
ORGASMS|ORGASM
ORIENTATIONS|ORIENTATION
ORIGINS|ORIGIN
ORMONDS|ORMOND
ORNAMENTATIONS|ORNAMENTATION
ORNITHOSIS|ORNITHOSES
OROPHARYNXS|OROPHARYNX
ORTHODONTICS|ORTHODONTIC
ORTHOMOLECULAR|ORTHOMOL
ORTHOMYXOVIRUSES|ORTHOMYXOVIRUS
ORTHOPANTOMOGRAPHY|ORTHOPANTOMOGRAPHIES
ORTHOPEDICS|ORTHOPEDIC
ORTHOPTERAS|ORTHOPTERA
ORTHOPTICS|ORTHOPTIC
ORTHOSIS|ORTHOSES
ORYZAS|ORYZA
ORYZIAS|ORYZIA
OSCILLATIONS|OSCILLATION
OSCILLATORS|OSCILLATOR
OSCILLOMETRY|OSCILLOMETRIES
OSMOLARITY|OSMOLARITIES
OSMOREGULATIONS|OSMOREGULATION
OSMOSIS|OSMOSES
OSSICLES|OSSICLE
OSSIFICANS|OSSIFICAN
OSSIFICATIONS|OSSIFICATION
OSTEITIS|OSTEITIDES
OSTEOARTHRITIS|OSTEOARTHRITIDES
OSTEOARTHROPATHY|OSTEOARTHROPATHIES
OSTEOBLASTOMAS|OSTEOBLASTOMA
OSTEOBLASTS|OSTEOBLAST
OSTEOCHONDRITIDES|OSTEOCHONDRIT
OSTEOCHONDRITIS|OSTEOCHONDRIT
OSTEOCHONDRODYSPLASIAS|OSTEOCHONDRODYSPLASIA
OSTEOCHONDROMAS|OSTEOCHONDROMA
OSTEOCHONDROMATOSIS|OSTEOCHONDROMATOSES
OSTEOCHONDROSIS|OSTEOCHONDROSES
OSTEOCLASTS|OSTEOCLAST
OSTEOCYTES|OSTEOCYTE
OSTEODYSTROPHY|OSTEODYSTROPHIES
OSTEOGENESIS|OSTEOGENESES
OSTEOLYSIS|OSTEOLYSES
OSTEOMALACIAS|OSTEOMALACIA
OSTEOMAS|OSTEOMA
OSTEOMYELITIS|OSTEOMYELITIDES
OSTEONECROSIS|OSTEONECROSES
OSTEOPATHY|OSTEOPATHIES
OSTEOPENIAS|OSTEOPENIA
OSTEOPETROSIS|OSTEOPETROSES
OSTEOPHYTOSIS|OSTEOPHYTOSES
OSTEOPOIKILOSIS|OSTEOPOIKILOSES
OSTEOPOROSIS|OSTEOPOROSES
OSTEORADIONECROSIS|OSTEORADIONECROSES
OSTEOSCLEROSIS|OSTEOSCLEROSES
OSTEOSYNTHESES|OSTEOSYN
OSTEOSYNTHESIS|OSTEOSYN
OSTEOTOMY|OSTEOTOMIES
OSTERTAGIASIS|OSTERTAGIASES
OSTHOLE|OSTHOL
OSTOMY|OSTOMIES
OTALGIAS|OTALGIA
OTITIS|OTITIDES
OTOCONIAS|OTOCONIA
OTOLARYNGOLOGY|OTOLARYNGOLOGIES
OTOLITHS|OTOLITH
OTORHINOLARYNGOLOGICAL|OTORHINOLARYNGOLOGIC
OTORHINOLARYNGOLOGY|OTORHINOLARYNGOLOGIES
OTORHINOLARYNOLOGIC|OTORHINOLARYNGOLOGIC
OTORRHEAS|OTORRHEA
OTOSCLEROSIS|OTOSCLEROSES
OTOSPONGIOSIS|OTOSPONGIOSES
OTTERS|OTTER
OUTBREAKS|OUTBREAK
OUTCOMES|OUTCOME
OUTLIERS|OUTLIER
OUTPATIENT|AMBULATORY
OUTPATIENTS|AMBULATORY
OUTPUTS|OUTPUT
OUTS|OUT
OVALE|OVAL
OVALES|OVAL
OVALOCYTOSIS|OVALOCYTOSES
OVARIAN|OVARIES
OVARIECTOMY|OVARIECTOMIES
OVARIOTEXY|OVARIOTEXIES
OVARIUS|OVARII
OVARY|OVARIES
OVERDOSES|OVERDOSE
OVEREATINGS|OVEREATING
OVERINCLUSIONS|OVERINCLUSION
OVERLEARNINGS|OVERLEARNING
OVERUTILIZATION|OVERUTIL
OVERUTILIZATIONS|OVERUTIL
OVERVIEWS|OVERVIEW
OVERWEIGHT|OBESITIES
OVIDUCTS|OVIDUCT
OVIPOSITIONS|OVIPOSITION
OVOCYTE|OOCYTE
OVOCYTES|OOCYTE
OVULATIONS|OVULATION
OVUM|OVA
OVUMS|OVA
OWNERSHIPS|OWNERSHIP
OXADIAZOLES|OXADIAZOLE
OXALATES|OXALATE
OXALOACETATES|OXALOACETATE
OXALURIAS|OXALURIA
OXATHINS|OXATHIINS
OXAZEPINES|OXAZEPINE
OXAZINE|OXAZIN
OXAZINES|OXAZIN
OXAZOLE|OXAZOL
OXAZOLES|OXAZOL
OXIDASES|OXIDASE
OXIDES|OXIDE
OXIDOREDUCTASES|OXIDOREDUCTASE
OXILOFRINE|OXILOFRIN
OXIMES|OXIME
OXIMETRY|OXIMETRIES
OXIPHEDRIN|OXIFEDRINE
OXOGLUTARATES|OXOGLUTARATE
OXOPROLINE|OXOPROLINAL
OXOQUINOLINES|OXOQUINOLINE
OXOSTEROIDS|OXOSTEROID
OXYCEPHALY|OXYCEPHALIES
OXYCHLOROQUINE|OXYCHLOROCHIN
OXYCLOZANIDE|OXICLOZANIDUM
OXYFEDRINE|OXIFEDRINE
OXYGENASES|OXYGENASE
OXYGENATIONS|OXYGENATION
OXYGENATORS|OXYGENATOR
OXYHEMOGLOBINS|OXYHEMOGLOBIN
OXYMETHOLONE|OXYMETHALONE
OXYPHEDRIN|OXIFEDRINE
OXYPROTHEPINE|OXYPROTHEPIN
OXYTERRACINE|OXYTERRACIN
OXYTHIAMINE|OXYTHIAMIN
OXYTREMORINE|OXOTREMORINE
OXYURIASIS|OXYURIASES
OYSTERS|OYSTER
OZENAS|OZENA
OZONIDES|OZONIDE
P388S|P388
PACEMAKERS|PACEMAKER
PACHYDERMOPERIOSTOSIS|PACHYDERMOPERIOSTOSES
PACIFIERS|PACIFIER
PACINGS|PACING
PACKAGINGS|PACKAGING
PAGETS|PAGET
PAINS|PAIN
PAINTINGS|PAINTING
PAINTS|PAINT
PAIRS|PAIR
PALATES|PALATE
PALATINUMS|PALATINUM
PALE|ALBA
PALEODONTOLOGY|PALEODONTOLOGIES
PALEOGRAPHY|PALEOGRAPHIES
PALEONTOLOGY|PALEONTOLOGIES
PALEOPATHOLOGIES|PALEOPATHOL
PALEOPATHOLOGY|PALEOPATHOL
PALLORS|PALLOR
PALMITATES|PALMITATE
PALMITYLCARNITINE|PALMITOYLCARNITINE
PALMS|PALM
PALPATIONS|PALPATION
PALPITATION|ARRHTHMIA
PALPITATIONS|ARRHTHMIA
PALSY|PALSIES
PAMPHLETS|PAMPHLET
PANAXANS|PANAXAN
PANCOASTS|PANCOAST
PANCREAS|PANCREA
PANCREAT|PANCREA
PANCREATECTOMY|PANCREATECTOMIES
PANCREATIC|PANCREA
PANCREATICOJEJUNOSTOMY|PANCREATICOJEJUNOSTOMIES
PANCREATITIS|PANCREATITIDES
PANCREATOJEJUNOSTOMIES|PANCREATICOJEJUNOSTOMIES
PANCREATOJEJUNOSTOMY|PANCREATICOJEJUNOSTOMIES
PANCYTOPENIAS|PANCYTOPENIA
PANENCEPHALITIDES|PANENCEPH
PANENCEPHALITIS|PANENCEPH
PANICS|PANIC
PANICUMS|PANICUM
PANLEUKOPENIAS|PANLEUKOPENIA
PANNICULITIS|PANNICULITIDES
PANODINE|PANODIN
PANOPHTHALMITIS|PANOPHTHALMITIDES
PANS|PAN
PANTOPAQUE|PANTHOPAQUE
PAPERS|PAPER
PAPILLAE|PAPILL
PAPILLAS|PAPILLA
PAPILLEDEMAS|PAPILLEDEMA
PAPILLITIS|PAPILLITIDES
PAPILLOMAS|PAPILLOMA
PAPILLOMAVIRUSES|PAPILLOMAVIRUS
PAPIOS|PAPIO
PAPOVAVIRUSES|PAPOVAVIRUS
PAPRINE|PAPRIN
PAPS|PAP
PAPULACANDINS|PAPULACANDIN
PAPULES|PAPULE
PARABIOSIS|PARABIOSES
PARACHUTINGS|PARACHUTING
PARACOCCIDIOIDOMYCOSIS|PARACOCCIDIOIDOMYCOSES
PARADOXICAL|PARADOXIC
PARAFFINS|PARAFFIN
PARAGANGLIAS|PARAGANGLIA
PARAGANGLIOMAS|PARAGANGLIOMA
PARAGONIMIASIS|PARAGONIMIASES
PARAIMMUNOGLOBULINEMIAS|PARAIMMUNOGLOBULINEMIA
PARAKEETS|PARAKEET
PARAKERATOSIS|PARAKERATOSES
PARALLAXS|PARALLAX
PARALYSIS|PARALYSES
PARAMEDICS|PARAMEDIC
PARAMETRITIS|PARAMETRITIDES
PARAMORPHAN|PARAMORFAN
PARAMYXOVIRUSES|PARAMYXOVIRUS
PARANEOPLASTIC|PARANEOPL
PARANOIAS|PARANOIA
PARANOID|PARANOIA
PARAPARESIS|PARAPARESES
PARAPHILIAS|PARAPHILIA
PARAPHIMOSIS|PARAPHIMOSES
PARAPHRENIAS|PARAPHRENIA
PARAPLEGIAS|PARAPLEGIA
PARAPROFESSIONALS|PARAPROFESSIONAL
PARAPROTEINEMIAS|PARAPROTEINEMIA
PARAPROTEINS|PARAPROTEIN
PARAPSORIASIS|PARAPSORIASES
PARAPSYCHOLOGY|PARAPSYCHOL
PARASITES|PARASITE
PARASITOLOGY|PARASITOL
PARASOMNIAS|PARASOMNIA
PARATHYROIDECTOMY|PARATHYROIDECTOMIES
PARATHYROIDINE|PARATHYROIDIN
PARATUBERCULOSIS|PARATUBERCULOSES
PARENTS|PARENT
PARESIS|PARESES
PARESTHESIAS|PARESTHESIA
PARITY|PARITIES
PAROMOMYCIN|PARAMOMYCIN
PARONYCHIAS|PARONYCHIA
PAROTITIS|PAROTITIDES
PAROXYSMAL|PAROX
PARROTS|PARROT
PART|
FRAGMENT
PARTHENOGENESIS|PARTHENOGENESES
PARTICIPATIONS|PARTICIPATION
PARTICLES|PARTICLE
PARTNERS|PARTNER
PARTS|FRAGMENT
PARVALBUMINS|PARVALBUMIN
PARVOVIRUSES|PARVOVIRUS
PARYLENES|PARYLENE
PASSAGES|PASSAGE
PASTE|ADHESIVE
PASTES|ADHESIVE
PASTEURELLAS|PASTEURELLA
PASTEURELLOSIS|PASTEURELLOSES
PATAS|PATA
PATCHES|PATCH
PATCHY|AREATA
PATELLAE|PATELLA
PATELLAS|PATELLA
PATENCY|PATENCIES
PATENTS|PATENT
PATERNITY|PATERNITIES
PATHOLOGIC|PATHOL
PATHOLOGICAL|PATHOL
PATHOLOGIES|PATHOL
PATHOLOGY|PATHOL
PATHWAY|PATHWAIES
PATHWAYS|PATHWAIES
PATIENTS|PATIENT
PATTERNS|PATTERN
PAYMENT|FEE
PAYMENTS|FEE
PCO2|CO2
PEANUTS|PEANUT
PEARLS|PEARL
PEAS|PEA
PEATS|PEAT
PECTINS|PECTIN
PECTORIS|PECTORI
PEDERINE|PEDERIN
PEDIATRICS|PEDIATRIC
PEDICULOSIS|PEDICULOSES
PEDICULUS|PEDICULI
PEDIGREES|PEDIGREE
PEDODONTICS|PEDODONTIC
PEDOPHILIAS|PEDOPHILIA
PEDUNCLES|PEDUNCLE
PEELING|PEEL
PEELINGS|PEEL
PEFLOXACINE|PEFLOXACIN
PELLAGRAS|PELLAGRA
PELLUCIDUMS|PELLUCIDUM
PELVIC|PELVI
PELVIMETRY|PELVIMETRIES
PELVIS|PELVI
PEMPHIGOIDS|PEMPHIGOID
PENALTY|PENALTIES
PENECILLIN|ANTIBIOTIC
PENETRATIONS|PENETRATION
PENICILLINS|PENICILLIN
PENILE|PENI
PENIS|PENI
PENSIONS|PENSION
PENTACINE|PENTACIN
PENTAMIDINE|PENTAMIDIN
PENTAMINE|PENTAMIN
PENTANES|PENTANE
PENTANOLS|PENTANOL
PENTANONES|PENTANONE
PENTAPEPTIDES|PENTAPEPTIDE
PENTENOIC|PENTENOATE
PENTETATES|PENTETATE
PENTOSANE|PENTOSAN
PENTOSEPHOSPHATES|PENTOSEPHOSPHATE
PENTOSES|PENTOSE
PENTOXIL|PENTOKSIL
PENTOXYL|PENTOKSIL
PENTYLENETETRAZOLE|PENTYLENETETRAZOL
PEOPLES|PEOPLE
PEPPERS|PEPPER
PEPSTATINS|PEPSTATIN
PEPTIDASES|PEPTIDASE
PEPTIDE|DIPEPTIDE
PEPTIDES|DIPEPTIDE
PEPTIDOGLYCANS|PEPTIDOGLYCAN
PEPTIDOHYDROLASES|PEPTIDOHYDROLASE
PEPTONES|PEPTONE
PERCAS|PERCA
PERCEPTIONS|PERCEPTION
PERCHLORATES|PERCHLORATE
PERCHLOROETHYLENE|PERCHLORETHYLENE
PERCHS|PERCH
PERCUSSIONS|PERCUSSION
PERFORATIONS|PERFORATION
PERFORMANCES|PERFORMANCE
PERFUMES|PERFUME
PERFUSIONS|PERFUSION
PERIADENITIS|PERIADENITIDES
PERIANAL|CIRCUMANAL
PERIAORTITIS|PERIAORTITIDES
PERIARTHRITIS|PERIARTHRITIDES
PERICARDIECTOMIES|PERICARDECTOMY
PERICARDIECTOMY|PERICARDECTOMY
PERICARDIOSTOMY|PERICARDIOSTOMIES
PERICARDIOTOMY|PERICARDIOTOMIES
PERICARDITIS|PERICARDITIDES
PERICARDIUM|PERICARDIAL
PERICARDIUMS|PERICARDIAL
PERICARDOTOMIES|PERICARDIOTOMIES
PERICARDOTOMY|PERICARDIOTOMIES
PERICEMENTITIS|PERICEMENTITIDES
PERICHONDRITIS|PERICHONDRITIDES
PERICORONITIS|PERICORONITIDES
PERIHILAR|HILAR
PERILYMPHS|PERILYMPH
PERIMETRY|PERIMETRIES
PERINATOLOGY|PERINATOLOGIES
PERINEPHRITIS|PERINEPHRITIDES
PERINEUM|PERINEAL
PERINEUMS|PERINEAL
PERIOD|MENSTRUAL
PERIODICALS|PERIODICAL
PERIODICITY|PERIODICITIES
PERIODONTICS|PERIODONTIC
PERIODONTITIS|PERIODONTITIDES
PERIODONTIUMS|PERIODONTIUM
PERIODONTOSIS|PERIODONTOSES
PERIODS|MENSTRUAL
PERIOPERATIVE|PERIOP
PERIOSTEUMS|PERIOSTEUM
PERIOSTITIDES|PERIOSTEITIS
PERIOSTITIS|PERIOSTEITIS
PERIPHERAL|PERIPH
PERIPHERALS|PERIPH
PERIPHLEBITIS|PERIPHLEBITIDES
PERIPLANETAS|PERIPLANETA
PERISSODACTYLAS|PERISSODACTYLA
PERISTALSIS|PERISTALSES
PERITONEOSCOPY|PERITONEOSCOPIES
PERITONEOVASCULAR|PERITONEOVAS
PERITONEUM|PERITONEAL
PERITONEUMS|PERITONEAL
PERITONEUS|PERITONEI
PERITONITIS|PERITONITIDES
PERMEABILITY|PERMEABILITIES
PERMEASES|PERMEASE
PERMISSIVENESSES|PERMISSIVENESS
PERMITTING|ALLOWING
PEROXIDASES|PEROXIDASE
PEROXIDATIONS|PEROXIDATION
PEROXIDES|PEROXIDE
PEROXISOMES|PEROXISOME
PERPHENAZINE|PERFENAZINE
PERSANTINE|PERSANTIN
PERSONALITY|PERSONALITIES
PERSONNELS|PERSONNEL
PERSONS|PERSON
PERSUASIONS|PERSUASION
PERTUSSIS|PERTUSSES
PERYLENE|PERILENE
PESSARY|PESSARIES
PESTICIDES|PESTICIDE
PESTIVIRUSES|PESTIVIRUS
PESTS|PEST
PETECHIAE|PETECHIA
PETECHIAL|PETECHIA
PETROLATUMS|PETROLATUM
PETROLEUMS|PETROLEUM
PETS|PET
PEYERS|PEYER
PEYRONIES|PEYRONIE
PHAGES|PHAGE
PHAGOCYTES|PHAGOCYTE
PHAGOCYTOSIS|PHAGOCYTOSES
PHAGOLYSOSOMES|PHAGOLYSOSOME
PHAGOSOMES|PHAGOSOME
PHALLOIDINE|PHALLOIDIN
PHALLOLYSINE|PHALLOLYSIN
PHANTOM|GHOST
PHARMACEUTIC|PHARM
PHARMACEUTICAL|PHARM
PHARMACIES|PHARM
PHARMACISTS|PHARMACIST
PHARMACOGENETICS|PHARMACOGENET
PHARMACOGNOSY|PHARMACOGNOSIES
PHARMACOKINETICS|PHARMACOKIN
PHARMACOLOGIC|PHARMACOL
PHARMACOLOGICAL|PHARMACOL
PHARMACOLOGIES|PHARMACOL
PHARMACOLOGY|PHARMACOL
PHARMACOPOEIAS|PHARMACOPOEIA
PHARMACOTHERAPIES|PHARMACOTHER
PHARMACOTHERAPY|PHARMACOTHER
PHARMACY|PHARM
PHARYNGEAL|PHARANGEAL
PHARYNGECTOMY|PHARYNGECTOMIES
PHARYNGES|PHARANGEAL
PHARYNGITIS|PHARYNGITIDES
PHARYNGOSTOMY|PHARYNGOSTOMIES
PHARYNX|PHARANGEAL
PHASES|PHASE
PHENANTHRENE|PHENANTHREN
PHENANTHRENES|PHENANTHREN
PHENANTHROLINES|PHENANTHROLINE
PHENAZINES|PHENAZINE
PHENESTERINE|PHENESTERIN
PHENETHYLAMINES|PHENETHYLAMINE
PHENOLPHTHALEINS|PHENOLPHTHALEIN
PHENOLS|PHENOL
PHENOLSULFONPHTHALEIN|PHENOLSULFONEPHTHALEIN
PHENOMENON|PHENOMENA
PHENOMENONS|PHENOMENA
PHENOTHIAZINES|PHENOTHIAZINE
PHENOTYPES|PHENOTYPE
PHENYLACETATES|PHENYLACETATE
PHENYLALANINE|PHENYLALANINAMIDE
PHENYLALANYL|PHENYLALANINAMIDE
PHENYLALANYLPHENYLALANYL|PHENYLALANYLPHENYLALANINE
PHENYLAMINES|PHENYLAMINE
PHENYLBARBITAL|PHENOBARBITAL
PHENYLENEDIAMINES|PHENYLENEDIAMINE
PHENYLETHANOLAMINE|PHENETHANOLAMINE
PHENYLETHYLAMINES|PHENYLETHYLAMINE
PHENYLHYDRAZINES|PHENYLHYDRAZINE
PHENYLKETONURIAS|PHENYLKETONURIA
PHENYLLACTIC|PHENYLLACTATE
PHENYLPROPIONATES|PHENYLPROPIONATE
PHENYLPROPIONIC|PHENYLPROPIONATE
PHENYLPYRIDINIUM|PHENYLPYRIDINE
PHEOCHROMOCYTOMAS|PHEOCHROMOCYTOMA
PHEOPHYTINS|PHEOPHYTIN
PHERESIS|PHERESES
PHEROMONES|PHEROMONE
PHILADELPHIA|PHILA
PHILIPPINES|PHILIPINES
PHILLIPINES|PHILIPINES
PHILLIPPINES|PHILIPINES
PHILOLOGY|PHILOLOGIES
PHILOSOPHY|PHILOSOPHIES
PHIMOSIS|PHIMOSES
PHIX|PHI
PHLEBITIS|PHLEBITIDES
PHLEBOGRAPHY|PHLEBOGRAPHIES
PHLEBOLITHS|PHLEBOLITH
PHLEBOTOMY|PHLEBOTOMIES
PHLEBOTONUS|PHLEBOTOMUS
PHLEOMYCINS|PHLEOMYCIN
PHLOXINE|PHLOXIN
PHOBIAS|PHOBIA
PHOCOMELIAS|PHOCOMELIA
PHONATIONS|PHONATION
PHONETICS|PHONETIC
PHONOCARDIOGRAPHY|PHONOCARDIOGRAPHIES
PHONOPHORESIS|PHONOPHORESES
PHORBOLS|PHORBOL
PHORIAS|PHORIA
PHOSPHATASES|PHOSPHATASE
PHOSPHATES|PHOSPHATE
PHOSPHATIDATES|PHOSPHATIDATE
PHOSPHATIDYLCHOLINES|PHOSPHATIDYLCHOLINE
PHOSPHATIDYLETHANOLAMINES|PHOSPHATIDYLETHANOLAMINE
PHOSPHATIDYLINOSITOLS|PHOSPHATIDYLINOSITOL
PHOSPHATIDYLSERINES|PHOSPHATIDYLSERINE
PHOSPHENES|PHOSPHENE
PHOSPHINES|PHOSPHINE
PHOSPHODIESTERASES|PHOSPHODIESTERASE
PHOSPHOGLYCERIDES|PHOSPHOGLYCERIDE
PHOSPHOGLYCOLLATE|PHOSPHOGLYCOLATE
PHOSPHOHYDROLASES|PHOSPHOHYDROLASE
PHOSPHOLIPASES|PHOSPHOLIPASE
PHOSPHOLIPIDS|PHOSPHOLIPID
PHOSPHOMONOESTERASES|PHOSPHOMONOESTERASE
PHOSPHONOACETIC|PHOSPHONACETIC
PHOSPHOPROTEINS|PHOSPHOPROTEIN
PHOSPHORESCENCES|PHOSPHORESCENCE
PHOSPHOROTHIOATES|PHOSPHOROTHIOATE
PHOSPHORUS|PHOSPHATE
PHOSPHORYLASES|PHOSPHORYLASE
PHOSPHORYLATIONS|PHOSPHORYLATION
PHOSPHOSERYL|PHOSPHOSERINE
PHOSPHOTRANSACYLASE|PHOSPHOTRANSACETYLASE
PHOSPHOTRANSFERASES|PHOSPHOTRANSFERASE
PHOTOALLERGY|PHOTOALLERGIES
PHOTOCHEMICAL|PHOTOCHEM
PHOTOCHEMISTRIES|PHOTOCHEM
PHOTOCHEMISTRY|PHOTOCHEM
PHOTOCHEMOTHERAPIES|PHOTOCHEMOTHER
PHOTOCHEMOTHERAPY|PHOTOCHEMOTHER
PHOTOCOAGULATIONS|PHOTOCOAGULATION
PHOTODERMATITIS|PHOTODERMATITIDES
PHOTOFLUOROGRAPHY|PHOTOFLUOROGRAPHIES
PHOTOGRAMMETRY|PHOTOGRAMMETRIES
PHOTOGRAPHS|PHOTOGRAPH
PHOTOGRAPHY|PHOTOGRAPHIES
PHOTOKYMOGRAPHY|PHOTOKYMOGRAPHIES
PHOTOLYSIS|PHOTOLYSES
PHOTOMETRY|PHOTOMETRIES
PHOTOMICROGRAPHY|PHOTOMICROGRAPHIES
PHOTONS|PHOTON
PHOTOPHOBIC|PHOTOPHOBIA
PHOTOPHOSPHORYLATIONS|PHOTOPHOSPHORYLATION
PHOTORADIATION|PHOTORAD
PHOTORADIATIONS|PHOTORAD
PHOTORECEPTORS|PHOTORECEPTOR
PHOTOSENSITIZATIONS|PHOTOSENSITIZATION
PHOTOSYNTHESES|PHOTOSYN
PHOTOSYNTHESIS|PHOTOSYN
PHOTOTHERAPIES|PHOTOTHER
PHOTOTHERAPY|PHOTOTHER
PHOTOTOXICITY|PHOTOTOXICITIES
PHRENOLOGY|PHRENOLOGIES
PHTHALAZINES|PHTHALAZINE
PHTHALIMIDES|PHTHALIMIDE
PHTHIROPTERA|PHTHIRAPTERA
PHYCOMYCETES|PHYCOMYCETE
PHYLLODES|PHYLLODE
PHYLOGENY|PHYLOGENIES
PHYSCIONE|PHYSCION
PHYSICAL|PHYS
PHYSICIAN|DOCTOR
PHYSICIANS|DOCTOR
PHYSICS|PHYSIC
PHYSIOGNOMY|PHYSIOGNOMIES
PHYSIOLOGIC|
PHYSIOL
PHYSIOLOGICAL|PHYSIOL
PHYSIOLOGIES|PHYSIOL
PHYSIOLOGY|PHYSIOL
PHYSIOTHERAPIES|PHYSIOTHER
PHYSIOTHERAPY|PHYSIOTHER
PHYTOALEXINS|PHYTOALEXIN
PHYTOHEMAGGLUTININS|PHYTOHEMAGGLUTININ
PHYTOMITOGENS|PHYTOMITOGEN
PHYTOSTEROLS|PHYTOSTEROL
PICAS|PICA
PICIBANYL|PICIBANIL
PICKS|PICK
PICODNAVIRUSES|PICODNAVIRUS
PICOLINES|PICOLINE
PICORNAVIRUSES|PICORNAVIRUS
PICTURES|PICTURE
PID|SALPINGITIDES
PIECE|FRAGMENT
PIEDRAS|PIEDRA
PIG|HOG
PIGEONS|PIGEON
PIGMENTARY|PIGMENT
PIGMENTATIONS|PIGMENTATION
PIGMENTED|PIGMENTATION
PIGMENTOSAS|PIGMENTOSA
PIGMENTS|PIGMENT
PIGMENTUS|PIGMENTI
PIGS|HOG
PILARIS|PILARI
PILE|HEMORRHOID
PILOERECTIONS|PILOERECTION
PILUS|PILI
PIMOBENDANE|PIMOBENDAN
PINEALOMAS|PINEALOMA
PINNIPEDIAS|PINNIPEDIA
PINOCEMBRINE|PINOCEMBRIN
PINOCYTOSIS|PINOCYTOSES
PINS|PIN
PINTAS|PINTA
PINWORMS|PINWORM
PIONS|PION
PIPERAZINES|PIPERAZINE
PIPERCILLIN|PIPERACILLIN
PIPERIDINES|PIPERIDINE
PIPERIDONES|PIPERIDONE
PIPEROXANE|PIPEROXAN
PIPETHIADENE|PIPETHIADEN
PIPOLPHEN|PIPOLFEN
PIPOTIAZIN|PIPOTHIAZINE
PIRAZETAM|PIRACETAM
PIRENZEPINE|PIRENZEPIN
PIRIBENDYL|PIRIBEDIL
PIRLINDOLE|PIRLINDOL
PIROPLASMOSIS|PIROPLASMOSES
PISTOL|FIREARM
PITS|PIT
PITYRIASIS|PITYRIASES
PLACEBOS|PLACEBO
PLACENTAE|PLACENTA
PLACENTAL|PLACENTA
PLACENTAS|PLACENTA
PLACENTATIONS|PLACENTATION
PLACENTOMAS|PLACENTOMA
PLACENTOMES|PLACENTOME
PLACES|PLACE
PLAGIARISMS|PLAGIARISM
PLAGUES|PLAGUE
PLAICES|PLAICE
PLANAS|PLANA
PLANETS|PLANET
PLANIGRAPHY|PLANIGRAPHIES
PLANKTONS|PLANKTON
PLANNING|PLAN
PLANNINGS|PLAN
PLANOTESTS|PLANOTEST
PLANS|PLAN
PLANTS|PLANT
PLAQUES|PLAQUE
PLASMACYTES|PLASMACYTE
PLASMACYTOMAS|PLASMACYTOMA
PLASMALOGENS|PLASMALOGEN
PLASMAPHERESIS|PLASMAPHERESES
PLASMAS|PLASMA
PLASMIDS|PLASMID
PLASMOCYTOMA|PLASMACYTOMA
PLASMOCYTOMAS|PLASMACYTOMA
PLASMOSOMES|PLASMOSOME
PLASTICAS|PLASTICA
PLASTICITY|PLASTICITIES
PLASTICS|PLASTIC
PLASTOCYANINE|PLASTOCYANIN
PLATANNAS|PLATANNA
PLATELETPHERESIS|PLATELETPHERESES
PLATELETS|PLATELET
PLATES|PLATE
PLATICHTHYS|PLATICHTHY
PLATINOL|PLATINO
PLATYBASIAS|PLATYBASIA
PLATYFISHS|PLATYFISH
PLATYPUS|PLATYPU
PLATYRRHINAS|PLATYRRHINA
PLAYINGS|PLAYING
PLAYS|PLAY
PLAYTHINGS|PLAYTHING
PLETHORA|HYPEREMIA
PLETHYSMOGRAPHY|PLETHYSMOGRAPHIES
PLEURAS|PLEURA
PLEURISY|PLEURISIES
PLEURODELES|PLEURODELE
PLEURODYNIAS|PLEURODYNIA
PLEURONECTES|PLEURONECTE
PLEURONECTIFORMES|PLEURONECTIFORME
PLEUROPNEUMONIAS|PLEUROPNEUMONIA
PLIPASTATINS|PLIPASTATIN
PLOIDY|PLOIDIES
PLUGS|PLUG
PLURIPOIETINS|PLURIPOIETIN
